б-ка=библиоте+ка
б-ки=библиоте+ки
б-ку=библиоте+ку
б-ке=библиоте+ке
б-к=библиоте+к
б-р=бульва+р
б-ра=бульва+ра
б-ру=бульва+ру
б-ром=бульва+ром
б-ре=бульва+ре
в-л=вокза+л
в-ла=вокза+ла
в-лазер=вэ-ла+зер
в-лу=вокза+лу
в-лом=вокза+лом
в-ле=вокза+ле
г-жа=госпожа+
г-же=госпоже+
г-жи=госпожи+
г-жу=госпожу+
г-жой=госпожо+й
г-жам=госпожа+м
г-жами=госпожа+ми
г-н=господи+н
г-на=господи+на
г-не=господи+не
г-ном=господи+ном
г-ну=господи+ну
гос-во=госуда+рство
гос-ва=госуда+рства
гос-ву=госуда+рству
гос-вом=госуда+рством
гос-ве=госуда+рстве
гос-в=госуда+рств
гос-вах=госуда+рствах
гос-вами=госуда+рствами
гос-вам=госуда+рствам
гос-ца=гости+ница
д-р=до+ктор
д-ра=до+ктора
д-ре=до+кторе
д-ром=до+ктором
д-ру=до+ктору
жит-во=жи+тельство
жит-ва=жи+тельства
з-д=заво+д
з-да=заво+да
з-ду=заво+ду
з-дом=заво+дом
з-де=заво+де
з-ды=заво+ды
з-дов=заво+дов
з-дам=заво+дам
з-дами=заво+дами
з-дах=заво+дах
изд-во=изда+тельство
изд-ва=изда+тельства
изд-ву=изда+тельству
изд-вом=изда+тельством
изд-ве=изда+тельстве
ин-т=институ+т
ин-та=институ+та
ин-ту=институ+ту
ин-том=институ+том
ин-ты=институ+ты
ин-тов=институ+тов
ин-там=институ+там
ин-тах=институ+тах
ин-тами=институ+тами
иск-во=иску+сство
иск-ва=иску+сства
иск-вом=иску+сством
иск-ву=иску+сству
иск-ве=иску+сстве
кв-л=кварта+л
кв-ла=кварта+ла
кв-лу=кварта+лу
кв-лом=кварта+лом
кв-ле=кварта+ле
кв-лы=кварта+лы
кв-лов=кварта+лов
кв-лам=кварта+лам
кв-лами=кварта+лами
кв-лах=кварта+лах
к-рый=кото+рый
к-рого=кото+рого
к-рому=кото+рому
к-рым=кото+рым
к-ром=кото+ром
к-рая=кото+рая
к-рой=кото+рой
к-рую=кото+рую
к-рое=кото+рое
к-рые=кото+рые
к-рых=кото+рых
к-рым=кото+рым
к-рыми=кото+рыми
к-т=комите+т
к-те=комите+те
к-та=кислота+
к-ты=кислоты+
к-ту=кислоту+
к-той=кислото+й
квт-ч=киловатт-ча+с
кол-во=коли+чество
кол-ва=коли+чества
кол-ве=коли+честве
кол-вом=коли+чеством
кол-ву=коли+честву
лит-ра=литерату+ра
лит-ры=литерату+ры
лит-рой=литерату+рой
лит-ре=литерату+ре
м-да=мда
м-р=ми+стер
м-ра=ми+стера
м-ре=ми+стере
м-ром=ми+стером
м-ру=ми+стеру
мин-во=министе+рство
мин-ва=министе+рства
мин-ву=министе+рству
мин-вом=министе+рством
мин-ве=министе+рстве
мин-в=министе+рств
мин-вам=министе+рствам
мин-вами=министе+рствами
мин-вах=министе+рствах
мкр-н=микрорайо+н
мкр-на=микрорайо+на
мкр-ну=микрорайо+ну
мкр-ном=микрорайо+ном
мкр-не=микрорайо+не
мкр-ны=микрорайо+ны
мкр-нов=микрорайо+нов
мкр-нам=микрорайо+нам
мкр-нами=микрорайо+нами
мкр-нах=микрорайо+нах
мн-к=многоуго+льник
мн-ка=многоуго+льника
мн-ку=многоуго+льнику
мн-ком=многоуго+льником
мн-ке=многоуго+льнике
мн-ки=многоуго+льники
мн-ков=многоуго+льников
мн-кам=многоуго+льникам
мн-ками=многоуго+льниками
мн-ках=многоуго+льниках
н-да=нда
нек-рый=не+который
нек-рого=не+которого
нек-рому=не+которому
нек-рым=не+которым
нек-ром=не+котором
нек-рая=не+которая
нек-рой=не+которой
нек-рую=не+которую
нек-рое=не+которое
нек-рые=не+которые
нек-рых=не+которых
нек-рым=не+которым
нек-рыми=не+которыми
о-ва=острова+
о-вов=острово+в
о-вах=острова+х
о-вам=острова+м
о-вами=острова+ми
об-во=о+бщество
об-ва=о+бщества
об-вом=о+бществом
об-ву=о+бществу
об-ве=о+бществе
об-вах=о+бществах
об-вами=о+бществами
об-вам=о+бществам
об-в=о+бществ
ог-ция=организа+ция
ог-ции=организа+ции
ог-цию=организа+цию
ог-цией=организа+цией
ог-циям=организа+циям
ог-циями=организа+циями
ог-циях=организа+циях
орг-ция=организа+ция
орг-ции=организа+ции
орг-цию=организа+цию
орг-цией=организа+цией
орг-циям=организа+циям
орг-циями=организа+циями
орг-циях=организа+циях
п-кт=проспе+кт
п-кта=проспе+кта
п-кту=проспе+кту
п-ктом=проспе+ктом
п-кте=проспе+кте
п-ов=полуо+стров
п-ова=полуо+строва
п-ову=полуо+строву
п-ове=полуо+строве
п-овом=полуо+стровом
пер-в=переры+в
пер-ва=переры+ва
пер-ву=переры+ву
пер-ве=переры+ве
пер-вом=переры+вом
пер-к=переу+лок
пл-ди=пло+щади
пл-дь=пло+щадь
пн-пт=понедельникпя+тница
пн-вс=понедельниквоскресе+нье
пр-во=прави+тельство
пр-ва=прави+тельства
пр-ве=прави+тельстве
пр-ву=прави+тельству
пр-вом=прави+тельством
пр-в=прави+тельств
пр-вам=прави+тельствам
пр-вами=прави+тельствами
пр-вах=прави+тельствах
пр-д=прое+зд
пр-да=прое+зда
пр-ду=прое+зду
пр-дом=прое+здом
пр-де=прое+зде
пр-кт=проспе+кт
пр-кта=проспе+кта
пр-кту=проспе+кту
пр-ктом=проспе+ктом
пр-кте=проспе+кте
пр-т=проспе+кт
пр-та=проспе+кта
пр-ту=проспе+кту
пр-том=проспе+ктом
пр-те=проспе+кте
произ-во=произво+дство
произ-ва=произво+дства
произ-ву=произво+дству
произ-вом=произво+дством
произ-ве=произво+дстве
произ-в=произво+дств
произ-вам=произво+дствам
произ-вами=произво+дствами
произ-вах=произво+дствах
пром-сть=промы+шленность
пром-сти=промы+шленности
пром-стью=промы+шленностью
пром-стей=промы+шленностей
пром-стям=промы+шленностям
пром-стями=промы+шленностями
пром-стях=промы+шленностях
р-он=райо+н
р-она=райо+на
р-н=райо+н
р-на=райо+на
р-ну=райо+ну
р-ном=райо+ном
р-не=райо+не
р-ны=райо+ны
р-нах=райо+нах
р-нов=райо+нов
р-нам=райо+нам
р-нами=райо+нами
сб-вс=суббота воскре+сенье
сб-ки=сбо+рники
сб-ков=сбо+рников
сб-кам=сбо+рникам
сб-ками=сбо+рниками
сб-ках=сбо+рниках
с-пб=санкт-петербу+рг
с-петербург=санкт-петербу+рг
с-петербурга=санкт-петербу+рга
с-петербургу=санкт-петербу+ргу
с-петербургом=санкт-петербу+ргом
с-петербурге=санкт-петербу+рге
стр-во=строи+тельство
стр-ва=строи+тельства
стр-ву=строи+тельству
стр-вом=строи+тельством
стр-ве=строи+тельстве
т-во=това+рищество
т-ва=това+рищества
т-ву=това+риществу
т-вом=това+риществом
т-ве=това+риществе
т-в=това+риществ
т-вам=това+риществам
т-вами=това+риществами
т-вах=това+риществах
темп-ра=температу+ра
темп-ры=температу+ры
темп-ре=температу+ре
темп-ру=температу+ру
темп-рой=температу+рой
темп-рою=температу+рою
темп-р=температу+р
темп-рам=температу+рам
темп-рами=температу+рами
темп-рах=температу+рах
ун-т=университе+т
ун-та=университе+та
ун-ту=университе+ту
ун-том=университе+том
ун-ты=университе+ты
ун-тов=университе+тов
ун-там=университе+там
ун-тами=университе+тами
ун-тах=университе+тах
ур-ние=уравне+ние
ур-ния=уравне+ния
ур-нию=уравне+нию
ур-нием=уравне+нием
ур-нии=уравне+нии
ур-ния=уравне+ния
ур-ний=уравне+ний
ур-ниям=уравне+ниям
ур-ниями=уравне+ниями
ур-ниях=уравне+ниях
уч-ся=уча+щиеся
уч-ще=учи+лище
уч-ща=учи+лища
уч-щу=учи+лищу
уч-щем=учи+лищем
уч-щ=учи+лищ
уч-щам=учи+лищам
уч-щами=учи+лищами
уч-щах=учи+лищах
ф-ка=фа+брика
ф-ки=фа+брики
ф-ке=фа+брике
ф-ку=фа+брику
ф-кой=фа+брикой
ф-к=фа+брик
ф-кам=фа+брикам
ф-ками=фа+бриками
ф-ках=фа+бриках
ф-т=факульте+т
ф-та=факульте+та
ф-ту=факульте+ту
ф-том=факульте+том
ф-те=факульте+те
ф-ты=факульте+ты
ф-тов=факульте+тов
ф-там=факульте+там
ф-тами=факульте+тами
ф-тах=факульте+тах
х-во=хозя+йство
х-ва=хозя+йства
х-ву=хозя+йству
х-вом=хозя+йством
х-ве=хозя+йстве
х-в=хозя+йств
х-вам=хозя+йствам
х-вами=хозя+йствами
х-вах=хозя+йствах
