аб=абэ+
аг=агэ+
азу=азу+
аи=аи+
ам=аэ+м
амт=аэмтэ+
ан=а+н
ант=а+нт
арб=аэрбэ+
ас=аэ+с
асу=асу+
бе=бе+
ваи=ваи+
га=гэа+
гаи=гаи+
гитис=ги+тис
го=гэо+
гост=го+ст
гэс=гэ+с
ер=еэ+р
жакт=жа+кт
иг=игэ+
игран=игра+н
ид=идэ+
иж=и+ж
ил=и+л
инка=иэнкаа+
каско=ка+ско
кмет=каэмйэтэ+
кокк=кокака+
кру=кру+
лгу=элгэу+
ли=ли+
лиаз=лиа+з
маи=маи+
мглу=эмгээлу+
мгу=эмгэу+
ми=ми+
мома=мо+ма
му=эму+
мю=эмъю+
наса=на+са
нато=на+то
од=одэ+
оду=оду+
озу=озу+
ока=ока+
оку=оку+
ому=ому+
оон=оо+н
оп=опэ+
опа=опа+
оперу=оперу+
ора=ора+
орс=оэрэ+с
орт=оэртэ+
ору=ору+
ос=оэ+с
осп=оэспэ+
оспу=оспу+
осу=осу+
ото=ото+
па=пэа+
пасе=пасе+
пе=пэе+
поцу=поцу+
про=про+
рапп=ра+пп
саку=саку+
сизо=сизо+
сита=сита+
сну=сну+
согу=согу+
соку=соку+
спи=спи+
су=су+
тасс=та+с
ту=тэу+
угу=угу+
уду=уду+
узу=узу+
ук=ука+
уса=уса+
усу=усу+
фа=эфа+
фау=фа+у
фиде=фидэ+
фила=фила+
фифа=фифа+
хозу=хозу+
шару=шару+
экю=экю+
эму=эму+
эс=э+с
эта=эта+
эту=эту+
юга=югэа+
як=я+к
мид=ми+д
фас=фа+с
воз=во+з
ран=ра+н
