аазсо=аазээсо+
аиф=аи+ф
аичпе=аичепэ+
акб=акабэ+
акм=акаэ+м
алба=а+лба
алроса=алро+са
амб=аэмбэ+
ано=ано+
аозт=аозэтэ+
аокк=аокака+
аолгу=аоэлгэу+
ао=ао+
аоот=аоотэ+
аотс=аотээ+с
апк=апэка+
аст=аэстэ+
асукп=асукапэ+
асуотп=асуотэпэ+
асутп=асутэпэ+
аупп=аупэпэ+
ауркка=ауэркака+
ахо=ахо+
аэдд=аэдэдэ+
аэс=аэ+с
аяс=ая+с
бажм=ба+жм
батс=батээ+с
бгас=бгас
бгинх=бэги+нх
бгитис=бэги+тис
бгиупх=бэгиупэха+
бгифк=бэги+фк
бдипч=бэдэипэче+
би=би+
бкпзе=бэкапэзэ+
бмв=бээмвэ+
бмоип=бмои+п
бризти=бри+зти
брэо=брэ+о
бтэи=бэтэи+
вадзи=ва+дзи
вадф=вадээ+ф
вамм=ваэмэ+м
вапп=вапэпэ+
варнитсо=варни+тсо
васж=ваэсжэ+
васпас=васпа+с
васф=ваэсэ+ф
васхнил=васхни+л
вахз=вахазэ+
ввак=вва+к
вваул=вва+ул
ввауш=вва+уш
ввму=вэвэмэу+
ввоо=вэвэоо+
ввуз=вву+з
ввус=вву+с
ввэр=ввэ+р
вгитис=вги+тис
вгиэвиз=вгиэ+виз
вгомми=вго+мми
вдапк=вда+пк
вднх=вэдэ+энха
вестлб=вестэлбэ+
взадт=взадэтэ+
вздро=вздро+
взипп=взипэпэ+
взипсм=взипээсэ+м
взипсх=взипэсэха+
взитлп=взитээлпэ+
взитп=взитэпэ+
взукт=взукатэ+
взэмт=взээмтэ+
виаркка=виаэркака+
визмаэ=визма+э
виигх=виигэха+
вилр=виэлэ+р
виммп=виэмэмпэ+
виозх=виозэха+
випбинк=випэбэиэнка+
випкизо=випки+зо
висм=ви+см
висти=ви+сти
висхаги=висха+ги
висхом=висхо+м
витгэо=витгэ+о
вифс=виэфэ+с
виэмр=виэмэ+р
виэмс=виэмэ+с
виэсх=виэсэха+
вкабанк=вэкааба+нк
вкка=вэкакаа+
вкоуп=вко+уп
вкумо=вкумо+
вма=вэмэа+
вмакв=вээмакавэ+
вми=вэмэи+
вмо=вэмэо+
вмс=вэмээ+с
вму=вэмэу+
вмф=вэмээ+ф
вниижт=внии+жт
вниитб=вниитэбэ+
внииэсм=внииэсэ+м
внииэсх=внииэсха+
внииягг=внииягэгэ+
вникицма=вники+цма
вниктирп=вникти+рп
вникфи=вникфи+
вниосп=внио+сп
внипп=вни+пп
внипрх=внипээрха+
внипти=внипти+
внирмми=внирми+
внитб=внитэбэ+
внититп=внититэпэ+
внитосс=внитоэсэ+с
внитс=внитээ+с
внифс=вниэфэ+с
внихфи=внихфи+
вниэмк=вниэмка+
вниэмс=вниэмэ+с
вниэсх=вниэсха
внориэ=внориэ+
внупп=вну+пп
ВО=вэо+
воапп=воа+пп
вовв=вовэвэ+
вовг=вовэгэ+
вовд=вовэдэ+
водгео=водге+о
воомп=вооэмпэ+
ворл=воэрэ+л
вотча=вотэча+
вохп=вохапэ+
вптиэмп=вэпэтэиэмпэ+
всегеи=всеге+и
всегингео=всегинге+о
всоир=всои+р
втопас=вто+пас
втуэ=вту+э
вумл=вумээ+л
вучк=вучека+
вфасоон=вээфасоо+н
вциом=вцио+м
вшо=вэшэо+
вшэ=вэшээ+
вэжх=вэжэха+
вэмк=вээмка+
вэрхр=вээрхаэ+р
вэтт=вэтэтэ+
габт=га+бт
габту=га+бту
гадн=га+дн
гаорсс=гаорэсэ+с
гасм=га+см
гатс=гатээ+с
гатт=гатэтэ+
гафкэ=га+фкэ
гахн=гахаэ+н
гвытм=гвытээ+м
гдоифк=гэдэои+фк
гибдд=гибэдэдэ+
гивд=гивэдэ+
гивс=ги+вс
гивц=гивэцэ+
гипл=ги+пл
гиттл=ги+тл
гифти=ги+фти
гмии=гмии+
гниихп=гниихапэ+
гнирри=гни+рри
гои=гои+
гопп=гопэпэ+
гохп=гохапэ+
гпиб=гпи+б
гпитпэп=гэпэитэпэ+п
гпояп=гэпэояпэ+
гпу=гэпэу+
гру=гээру+
гспэу=гээспэу+
гувд=гувэдэ+
гувп=гувэпэ+
гувс=гувээ+с
гугб=гугэбэ+
гугс=гугээ+с
гугш=гугэша+
гужс=гужээ+с
гузм=гузээ+м
гукк=гукака+
гукф=гукаэ+ф
гукх=гукаха+
гумз=гуэмзэ+
гумпво=гумпэвэо+
гупв=гупэвэ+
гупп=гупэпэ+
гупс=гу+пс
гурв=гуэрвэ+
гусх=гуэсха+
гуцб=гуцэбэ+
гуцр=гуцээ+р
гфи=гэфэи+
гфо=гэфэо+
гфп=гэфэпэ+
гфр=гэфээ+р
гфти=гээфтэи+
гфц=гэфэцэ+
гфш=гэфэша+
гэднпип=гэдээнпи+п
гэмикш=гэмикаша+
гэпц=гэпэцэ+
дагзэто=дагэзэтэо+
дармс=да+рмс
двпии=дэвэпии+
дгтэу=дэгэтэу+
ддэ=дэдээ+
дисс=дисс
дитр=ди+тр
днк=дээнка+
довсе=довсе+
доп=до+п
допр=до+пр
досфлот=досфло+т
дпни=дэпэнэи+
дрпио=дээрпио+
дрсу=дээрсу+
дувз=дувэзэ+
дужк=дужэка+
дфи=дэфэи+
дэмш=дээмша+
дэсп=дээспэ+
дэтс=дэтээ+с
дюсш=дюэсша+
еагс=еагээ+с
еао=еао+
еасс=еаэсэ+с
еаст=еаэстэ+
егэ=егэ+
езмо=езэмэо+
ес=еэ+с
есакп=есакапэ+
еспи=еэспэи+
еэк=еэка+
еэс=еэ+с
жвон=жво+н
ждуз=жду+з
жко=жекао+
жкх=жэкэха+
жро=жэрэо+
жэтф=жэтээ+ф
жэу=жэ+у
забво=забвэо+
забжд=забэжедэ+
закводгео=закводге+о
закгеомин=закгеоми+н
зао=зао+
зииссп=зииэсэспэ+
зирп=зиэрпэ+
зирс=зиэрэ+с
зотс=зотээ+с
зурв=зуэрвэ+
зурс=зуэрэ+с
зшувд=зэшаувэдэ+
иа=иа+
иапз=иапэзэ+
игбэ=игэбээ+
иижс=иижээ+с
иижт=ии+жт
иипс=иипээ+с
ииск=ииэска+
илгу=иэлгэу+
илиязв=илиязэвэ+
илязв=илйазэвэ+
имгу=иэмгэу+
имту=имту+
имхим=имхи+м
инби=инби+
инбюм=иэнбэюэ+м
инг=иэнгэ+
инн=иэнэ+н
инска=иэнэска+
иос=и+ос
ип=ипэ+
ипквод=ипэкаво+д
ипкир=ипки+р
ипкпон=ипэкапо+н
ипта=ипта+
иптад=ипта+д
иптап=ипта+п
ипто=ипто+
иргупс=иргу+пс
ис=иэ+с
испр=испр
испэ=испэ+
исса=и+сса
исхи=исхи+
итомкх=итоэмкаха+
ифвэ=иэфвэ+
ифха=ифха+
ифхи=ифхи+
ихти=ихти+
иэмг=иэмгэ+
иэмп=иэмпэ+
йар=йа+р
ка=ка+
кавз=кавэзэ+
казс=казээ+с
канарспи=канарспи+
капш=капэша+
касб=каэсбэ+
катс=катээ+с
кбао=кэба+о
кбасср=кэбаэсэсэ+р
кгб=кэгэбэ+
кгиоп=кагио+п
кзаг=кэзэагэ+
кзот=кзо+т
киас=ки+ас
кивм=кивээ+м
кивс=кивээ+с
кивц=кивэцэ+
кипмкипп=кипээмкипэпэ+
кирв=киэрвэ+
ккао=кака+о
кккукс=какакау+кс
ккоми=какоэмъи+
кмастрой=каэмастро+й
кмоп=кмо+п
кмор=каэмоэ+р
кнаапо=кнаапо+
кнап=кна+п
книипп=книи+пп
книрс=кни+рс
кноз=кно+з
коап=коа+п
ковм=ковээ+м
ковр=ковээ+р
копн=копээ+н
кп(б)=капэбэ+
кпас=капэаэ+с
кпибв=капэибэвэ+
кпуг=капэугэ+
кпуз=капэузэ+
кпуниа=кпу+ниа
кпяш=капэяша+
крастэц=крастэ+ц
крзуро=каэрзу+ро
ксаз=кса+з
ксус=ксу+с
ктап=кта+п
ктоф=кто+ф
ктэ=катээ+
ктэо=ктэ+о
ктэу=ктэ+у
ку=кау+
куапф=куапээ+ф
кубс=кубээ+с
кувкс=кувэкаэ+с
кувс=кувээ+с
кузгпа=кузгэпэа+
куомс=куоэмэ+с
куопп=куопэпэ+
купп=купэпэ+
кутв=кутэвэ+
куфк=куэфка+
кхл=кэхээ+л
кэатс=кэатээ+с
кэсв=кээсвэ+
лабифр=лабиэфэ+р
лавд=лавэдэ+
лагг=лагэгэ+
лакп=лакапэ+
лалп=лаэлпэ+
ланл=лаэнэ+л
лапп=лапэпэ+
лармс=лаэрэмэ+с
латр=латээ+р
лафх=лаэфха+
лачх=лачеха+
лбан=элбэаэ+н
лбап=элбэапэ+
лбаэс=элбэаэ+с
лбепо=элбэпэо+
лваиу=элваиу+
лввиа=элвэвэиа+
лвиму=лви+му
лгиа=лги+а
лгик=лги+к
лгили=лгили+
лгок=лго+к
лгот=лго+т
лгумп=элгэуэмпэ+
лгэс=лгэ+с
лдэм=элдээ+м
лед=элйэдэ+
лжамц=элжэаэмцэ+
лзии=элзии+
лиимп=лии+мп
лиипс=лии+пс
ликп=ли+кп
липз=липэзэ+
липкри=липкаэръи+
липкх=липэкаха+
литт=литэтэ+
лихмп=лихаэмпэ+
лихп=лихапэ+
лниви=лниви+
лнииа=лнииа+
лниипп=лниипэпэ+
ловд=ловэдэ+
ловодгео=ловодге+о
ловсу=ловсу+
лозку=лозку+
лозта=лозта+
локз=локазэ+
локк=локака+
лоллта=лоэлэлтэа+
ломз=ломэзэ+
ломо=ломо+
лонпи=лоэнпэи+
лоокс=лоокаэ+с
лоокт=лоокатэ+
лосп=лоэспэ+
лоспо=лоспо+
лоспс=лоэспээ+с
лоссх=лоэсэсха+
лоуегмс=лоуегээмэ+с
лоукбтм=лоукабэтээ+м
лоумп=лоуэмпэ+
лоучгиз=лоучги+з
лоцкти=лоцэкатэи+
лоцт=лоцэтэ+
лоцф=лоцээ+ф
лпфэи=элпэфэи+
лтэи=элтэи+
лтэу=элтэу+
лувд=лувэдэ+
лукко=лу+кко
лфти=элфэтэи+
лфэи=элфэи+
лэтз=лэтэзэ+
лэтис=лэ+тис
мавп=мавэпэ+
магн=магээ+н
макто=макто+
мамтл=маэмтээ+л
мапдо=мапэдэо+
мапн=мапээ+н
мапп=мапэпэ+
маппу=мапэпэу+
мархи=мархи+
маспог=маспо+г
мвипи=эмвэипи+
мготзн=эмгэотэзээ+н
мигг=ми+г
минб=ми+нб
мо=эмо+
мобса=мобээса+
мтс=эмтээ+с
мфи=эмфэи+
мфп=эмфэпэ+
ндфл=эндэфээ+л
нии=нии+
нииас=ниа+с
ниокр=нио+кр
нипи=нипи+
нитиом=нитио+м
нифхи=нифхи+
нихфи=нихфи+
ницро=ницро+
нкао=энка+о
нкап=энкапэ+
нкат=энкатэ+
нкид=нки+д
нкэс=энкаэ+с
нло=энэло+
нэвз=нэвэзэ+
оао=оао+
оаэ=оаэ+
обэп=обэ+п
обсе=обээсйэ+
обти=обти+
обьгэс=обьгэ+с
овд=овэдэ+
овк=овэка+
ово=ово+
огми=огэмэи+
огпи=огэпэи+
огпу=огэпэу+
огу=огу+
одва=одва+
одмо=одмо+
одо=одо+
ождт=ожедэтэ+
оиаэ=оиаэ+
оидр=ои+др
ок=оке+й
окато=ока+то
окб=окабэ+
окои=окои+
окопф=око+пф
окпо=окпо+
окр=о+кр
ола=ола+
онпз=оэнпэзэ+
ону=ону+
оо=оо+
ооо=ооо+
оопз=оопэзэ+
опво=опэвэо+
опзу=опэзэу+
оптэ=оптэ+
опу=опу+
орви=оэрви+
оро=оро+
орпо=орпо+
осаго=оса+го
осао=оса+о
осга=осга+
осмп=оэсэмпэ+
оснаа=оснаа+
оснаал=оснаа+л
осо=осо+
оспо=оспо+
осфрум=осфру+м
осхи=осхи+
отп=отэпэ+
оту=оту+
офбу=офэбэу+
офл=оэфэ+л
офп=офэпэ+
офт=офэтэ+
оца=оца+
очу=очу+
ошу=ошу+
оэ=оэ+
пво=пэвэо+
пдэс=пэдээ+с
пк=пэка+
пкио=пэкаио+
пмэф=пээмэ+ф
ПО=пэо+
пово=пово+
повп=повэпэ+
покф=покаэ+ф
поо=поо+
ппэо=пэпэо+
ппэс=пэпээ+с
птабатр=птаба+тр
птаэс=пэтэаэ+с
птур=пту+р
птурс=пту+рс
птус=пту+с
птэн=птэ+н
пугувд=пугувэдэ+
пумо=пумо+
путс=путээ+с
пэвм=пэвээ+м
радпосн=радпо+сн
райнто=райэнтэо+
рамсо=рамсо+
рао=ра+о
рапл=ра+пл
ргик=рги+к
ритц=ри+тц
ркка=эркэкэа+
ркпб=эркапэбэ+
ровд=ровэдэ+
рокк=рокака+
роно=роно+
ропга=ро+пга
роэ=ро+э
рсу=эрсэу+
рткомм=эртко+м
ру=ру+
рувд=рувэдэ+
рэа=рэ+а
рэу=рэ+у
савфсз=савээфэсзэ+
самгу=самгэу+
санигми=сани+гми
саникис=сани+кис
сановно=сано+вно
сарнигми=сарни+гми
саэрхр=саэрхаэ+р
свао=сва+о
свердл=свердл
сзао=сза+о
сзт=сэзэтэ+
сибниизхоз=сибниизхо+з
сибюи=сибъюи+
сио=сио+
скво=скво+
скниви=скни+ви
смо=смо+
сму=сму+
снабгрэс=снабгрэ+с
снг=эсэнгэ+
сокк=сокака+
соккикп=сокакаикапэ+
соэ=со+э
спбгу=эспэбэгэу+
субд=субэдэ+
сумуо=сумуо+
сурбд=суэрбэдэ+
сша=сэшэа+
сши=сэшэи+
сшо=сэшэо+
тапв=тапэвэ+
тарэ=тарэ+
тинро=тинро+
типо=типо+
ткшиняз=тэкашинйа+з
тнгибанк=тээнгэиба+нк
тоо=тоо+
топз=топэзэ+
тп=тэпэ+
тпэс=тэпээ+с
тсж=тэсэжэ+
тупэ=тупэ+
тэвз=тэвэзэ+
тэжэ=тэжэ+
тэзс=тэзээ+с
тэмз=тээмзэ+
тэпф=тэпээ+ф
тэрз=тээрзэ+
тюмгнгу=тюмгээнгэу+
уапв=уапэвэ+
уапп=уапэпэ+
уарв=уаэрвэ+
уасс=уаэсэ+с
убко=убэкао+
уввуз=увву+з
увд=увэдэ+
увку=увку+
увмуз=увму+з
уво=уво+
увопж=увопэжэ+
уву=уву+
уга=уга+
уге=уге+
удо=удо+
уефа=уефа+
ужгу=ужгэу+
узо=узо+
уипф=уипээ+ф
уко=уко+
уктэа=уктэ+а
уктэо=уктэ+о
улгту=улгэтэу+
улзу=улзу+
умо=умо+
умэ=умэ+
унгрин=унгри+н
упво=упэвэо+
упо=упо+
упте=упте+
упу=упу+
упчи=упчи+
урв=урвэ+
урвв=урвэвэ+
урвп=урвэпэ+
уро=уро+
усапп=усапэпэ+
усо=усо+
усэ=усэ+
усэпп=усэпэпэ+
ута=ута+
утапв=утапэвэ+
уто=уто+
уузк=уузэка+
уфмс=уфэмээ+с
уфо=уфо+
уфу=уфу+
ухлу=ухлу+
учпу=учпу+
фбр=фэбээ+р
фв=фэвэ+
фвуа=эфвэуа+
фзаб=эфзэабэ+
фзу=фэзэу+
фиа=фиа+
фина=фина+
фио=фио+
фнс=фээнэ+с
фом=фом
фрг=фээргэ+
фргф=фээргээ+ф
фсб=фээсбэ+
фск=фээска+
фскн=фээскаэ+н
фсс=фээсэ+с
фту=фэтэу+
фэи=фэи+
хирэ=хирэ+
хмао=хмао+
хниияли=хниия+ли
хру=харэу+
хфи=хэфэи+
цабои=цабо+и
цабэи=цабэ+и
цавту=цавту+
цаги=ца+ги
цази=ца+зи
цао=ца+о
цвэи=цвэ+и
цгои=цэгэои+
цгок=цэгэока+
цететис=цете+тис
цзаи=цэзэаи+
цзии=цэзэии+
цизо=цизо+
цизпо=цизпо+
цниаги=цниа+ги
цнии=цнии+
цниикз=цнииказэ+
цниипп=цниипэпэ+
цнимб=цниэмбэ+
цнимпс=цниэмпээ+с
цнип=цни+п
цнипи=цнипи+
цнипки=цни+пки
цнипс=цнипээ+с
цнирх=цни+рх
цнис=цни+с
цнита=цни+та
цнити=цнити+
цнихби=цни+хби
цовз=цовэзэ+
цовр=цовээ+р
цопф=цо+пф
цотл=цотээ+л
цпко=цэпэкэо+
цпкио=цэпэкэо+
црт=цээртэ+
цру=цээру+
цруб=цру+б
цря=цээрйа+
цска=цээска+
цсюн=цээсйуэ+н
цсют=цээсйутэ+
цто=цэтэо+
цубда=цу+бда
цувд=цувэдэ+
цувс=цувээ+с
цукл=цукаэ+л
цулп=цуэлпэ+
цумв=цуэмвэ+
цумз=цуэмзэ+
цумр=цумээ+р
цунху=цунху+
цурт=цуэртэ+
цэвс=цэвээ+с
цэлги=цээлгэи+
цэлт=цээлтэ+
цэситм=цэситээ+м
цэтс=цэтээ+с
чусто=чусто+
шос=шо+с
эавм=эавээ+м
эакк=эакака+
эгсу=эгээсу+
эда=эдэа+
эдму=эдээму+
эке=эке+
экза=экза+
экла=экла+
экосто=эко+сто
эку=эку+
эма=эмэа+
эме=эмэ+
эмко=эмко+
эмо=эмо+
эпу=эпу+
эрпо=эрпо+
эса=эса+
эсза=эсза+
эсо=эсо+
эсу=эсу+
эсха=эсха+
юва=ювэа+
югпу=югэпэу+
юк=юка+
юужд=юужэдэ+
юфджей=юэфдже+й
яасср=яаэсэсэ+р
ямр=ямээр
яэмз=яэмзэ+
мвидео=эмви+део
нтв=энтэвэ+
нтв+=энтэвэ+ плю+с
мвд=эмвэдэ+
pdf=пэдээ+ф
гтс=гэтээ+с
рбк=эрбэка+
угибдд=угибэдэдэ+
цб=цэбэ+
рф=э+рэ+ф
дпс=дэпээ+с
ссср=эсэсэсэ+р
мкс=эмкаэ+с
еспч=еэспэчэ+
мк=эмка+
лдп=элдэпэ+
втб=вэтэбэ+
тко=тэкэо+
риа=ри+а
сми=сми+
