деньги=де+ньги
ком=ко+м
ка=ка+
либо=ли+бо
заворовавшихся=заворова+вшихся
доброту=доброту+
именно=и+менно
роман=рома+н
молодец=молоде+ц
чесным=че+сным
заметь=заме+ть
нибудь=нибу+дь
городка=городка+
никуда=никуда+
силами=си+лами
октября=октября+
орбиту=орбиту+
сбои=сбо+и
станислав=станисла+в
вину=вину+
директоров=директоро+в
портал=по+ртал
страну=страну+
перу=перу+
сбоях=сбо+ях
портала=порта+ла
воды=воды+
путин=пу+тин
минобороны=миноборо+ны
лавров=лавро+в
паюшин=паю+шин
гекльберри=гекльберри+
иванов=ивано+в
шварцнеггер=шварцне+ггер
дела=дела+
антитела=антитела+
катя=ка+тя
богдан=богда+н
герман=ге+рман
aдам=aда+м
мария=мари+я
марина=мари+на
иван=ива+н
галина=гали+на
рустам=руста+м
максим=макси+м
элина=эли+на
филипп=фили+пп
альберт=альбе+рт
алиса=али+са
анжела=анже+ла
один=оди+н
кредит=креди+т
кредиту=креди+ту
кредитом=креди+том
кредитам=креди+там
кредитов=креди+тов
должно=должно+
гульнара=гульна+ра
карен=каре+н
мощностей=мощносте+й
секторов=секторо+в
комплексный=ко+мплексный
ранее=ра+нее
разъяснить=разъясни+ть
дону=дону+
статей=стате+й
статью=статью+
отраслях=отрасля+х
характерные=характе+рные
продвигаться=продвига+ться
состаревшемуся=соста+ревшемуся
стороны=сто+роны
запасных=запасны+х
боях=боя+х
премиум=пре+миум
цены=це+ны
газа=га+за
связи=связи+
полях=поля+х
высоко=высоко+
украине=украи+не
путина=пу+тина
астана=астана+
тату=тату+
роллап=ролла+п
затестить=зате+стить
разрулится=разру+лится
добывателям=добыва+телям
листинговался=листингова+лся
необоротных=необоро+тных
тедди=те+дди
видеопромо=видеопро+мо
криптовалютности=криптовалю+тности
журналирующие=журнали+рующие
персонализуем=персонализу+ем
криптомиры=криптомиры+
стартапщиков=старта+пщиков
дизайнный=диза+йнный
мемкойн=мемко+йн
рокет=ро+кет
секундичном=секу+ндичном
мультисигнатур=мультисигнату+р
субграфы=субгра+фы
техкранч=техкра+нч
булшитить=булши+тить
иванываныч=иваныва+ныч
аккаунтинг=акка+унтинг
криптообмен=криптообме+н
децентрализованности=децентрализо+ванности
малорепрезентативные=малорепрезентати+вные
наростать=нароста+ть
увдомления=увдомле+ния
триколорный=триколо+рный
райли=ра+йли
потоково=пото+ково
непроцентном=непроце+нтном
зельдой=зе+льдой
акселераторской=акселера+торской
криптомайнинг=криптома+йнинг
инвестментах=инве+стментах
оффицер=оффице+р
интерпретированы=интерпрети+рованы
криптомайнинг=криптома+йнинг
ругпула=ругпу+ла
вымаркированным=вымарки+рованным
идентифицирующие=идентифици+рующие
тикток=тикто+к
инновативных=инновати+вных
клауд=кла+уд
бьюти=бью+ти
мультиплеерные=мультиплее+рные
залогинен=залоги+нен
альткойнов=альтко+йнов
десантиса=деса+нтиса
микромобильности=микромоби+льности
криптозапое=криптозапо+е
стейкингом=сте+йкингом
ругпулы=ругпу+лы
покопиться=покопи+ться
пинтерест=пи+нтерест
транзакционным=транзакцио+нным
элон=э+лон
марвел=ма+рвел
оздоравливает=оздора+вливает
запустившейся=запусти+вшейся
гиперреалистичным=гиперреалисти+чным
коинами=кои+нами
мемкоины=мемко+ины
криптоэксперт=криптоэкспе+рт
коин=ко+ин
иванываныча=иваныва+ныча
шэринг=шэ+ринг
эксель=эксе+ль
диверсификационным=диверсификацио+нным
инвестмент=инве+стмент
криптоинструментов=криптоинструме+нтов
хэшрейт=хэшре+йт
метавселенная=метавселе+нная
коллаборативное=коллаборати+вное
морозовую=моро+зовую
фэнов=фэ+нов
криптомаркета=криптома+ркета
датабэйс=датабэ+йс
мультиплеерных=мультипле+ерных
профитным=про+фитным
метавселенную=метавселе+нную
шэрингом=шэ+рингом
внутрисалонное=внутрисало+нное
криптолендинг=криптоле+ндинг
законодателство=законода+телство
суперкруто=суперкру+то
акумулляция=акумулля+ция
геймерши=ге+ймерши
безопасностным=безопа+сностным
акселераторскую=акселера+торскую
искуственного=иску+ственного
програмы=програ+мы
коинбейс=ко+инбейс
неструктурированных=неструктури+рованных
твича=тви+ча
эксплоитерам=экспло+итерам
спотифай=спотифа+й
криптомире=криптоми+ре
сайдчейны=сайдче+йны
криптозона=криптозо+на
отзеркальное=отзерка+льное
фиатной=фиа+тной
чатботов=чатбо+тов
стейнберг=сте+йнберг
мемекоины=мемеко+ины
многоцепочечной=многоцепо+чечной
аудитирования=аудити+рования
скетчом=ске+тчом
безопасностном=безопа+сностном
овер=о+вер
мультитаскинга=мультита+скинга
зверопой=зверопо+й
самоуправляющих=самоуправля+ющих
малорепрезентативных=малорепрезентати+вных
застейкано=засте+йкано
ассетов=ассе+тов
неструктурированные=неструктури+рованные
затронуться=затро+нуться
метавселенными=метавселе+нными
криптоинвестициями=криптоинвести+циями
супербыстрые=супербы+стрые
мультиблокчейн=мультиблокче+йн
подорбитальная=подорбита+льная
контрактируются=контракти+руются
криптоинвестирование=криптоинвести+рование
мощьности=мо+щьности
радиообсуждения=радиообсужде+ния
ористуются=ористу+ются
многоспорную=многоспо+рную
трейдинговые=тре+йдинговые
воробьишко=воробьи+шко
вестворлд=вество+рлд
неосновные=неосновны+е
недельной=неде+льной
впечатлилась=впечатли+лась
грузоперевозочную=грузоперево+зочную
комодитиз=комо+дитиз
стэйблкоин=стэйблко+ин
аллилуия=аллилу+ия
транслатинные=транслати+нные
пупер=пу+пер
артифакт=артифа+кт
криптоинвестициях=криптоинвести+циях
токенизированные=токенизи+рованные
сложновато=сложнова+то
безстраховые=безстраховы+е
мультискрина=мультискрина+
сконвертировано=сконверти+ровано
стереокатушек=стереокату+шек
метавиртуальном=метавиртуа+льном
криптопроекты=криптопрое+кты
предоплаченного=предопла+ченного
разработку=разрабо+тку
апи=апи+
деплоймент=депло+ймент
сторис=сто+рис
двухдискуссионное=двухдискуссио+нное
коины=ко+ины
рубешок=рубешо+к
внутридневной=внутридне+вной
децентрализационных=децентрализацио+нных
стэйкинга=стэ+йкинга
стейблкоины=стейблко+ины
заспамил=заспа+мил
безэкономических=безэкономи+ческих
бибезопасности=бибезопа+сности
ютюбер=ютю+бер
стейкинга=сте+йкинга
минималистичной=минималисти+чной
раскупятся=раску+пятся
аксессоры=аксе+ссоры
многодетальное=многодета+льное
роботические=роботи+ческие
стейкеры=сте+йкеры
криптобанки=криптоба+нки
микро=ми+кро
чжао=чжа+о
полудуманные=полуду+манные
тиктоке=тикто+ке
релизной=рели+зной
обеспокоительно=обеспокои+тельно
выделели=вы+делели
маруська=мару+ська
мультисетевой=мультисетево+й
безрискованных=безриско+ванных
благуспешной=благуспе+шной
лансировании=ланси+ровании
халявку=халя+вку
сейлор=се+йлор
десятиконечных=десятиконе+чных
мониторятся=монито+рятся
чатбота=чатбо+та
дюймовый=дюймо+вый
криптодевелоперов=криптодеве+лоперов
криптобиржевых=криптоби+ржевых
офферов=оффе+ров
метавселенная=метавселе+нная
метавселенной=метавселе+нной
хардварные=хардва+рные
неответственно=неотве+тственно
стэйкинге=стэ+йкинге
гана=га+на
энтузиастов=энтузиа+стов
мемкоин=мемкои+н
финанс=фина+нс
напоминалку=напомина+лку
ютюба=ютю+ба
рефрен=рефре+н
напоследок=напосле+док
трейдинговой=трейди+нговой
криптомайнингом=криптома+йнингом
необанки=необа+нки
бумаги=бума+ги
подтвердились=подтверди+лись
легаси=ле+гаси
неформальных=неформа+льных
двухфондовый=двухфо+ндовый
крипторганизациям=крипторганиза+циям
перезапустить=перезапусти+ть
несанкционированно=несанкциони+рованно
байдена=ба+йдена
спейсэкс=спейсэ+кс
сбоев=сбо+ев
расса=ра+сса
онлайн=онла+йн
оставайтесь=остава+йтесь
прекрасно=прекра+сно
буллинг=булли+нг
ютубера=юту+бера
гипер=ги+пер
токенизированными=токенизи+рованными
майкла=ма+йкла
биткоинов=битко+инов
виток=вито+к
страховательной=страхова+тельной
мэрия=мэ+рия
душеразжигательная=душеразжига+тельная
несерьезничаю=несерье+зничаю
пугающе=пуга+юще
макдональдсе=макдо+нальдсе
блокчейн=блокче+йн
краткосрочные=краткосро+чные
криптоинвесторов=криптоинве+сторов
информированный=информи+рованный
свобода=свобо+да
чатботы=чатбо+ты
посмеивается=посме+ивается
невыбранных=невы+бранных
суперкреативные=суперкреати+вные
горевал=горева+л
штучного=шту+чного
хэштеги=хэште+ги
джедайский=джеда+йский
трейдинговыми=тре+йдинговыми
мотивирующее=мотиви+рующее
чатботе=чатбо+те
криптофирмы=криптофи+рмы
майнерское=ма+йнерское
делегаторам=делега+торам
дропбокс=дропбо+кс
крипто=кри+пто
мультичейн=мультиче+йн
криптопроектов=криптопрое+ктов
баргинами=барги+нами
субграфов=субгра+фов
продуктов=проду+ктов
давным=давны+м
овервотч=оверво+тч
метавиртуальности=метавиртуа+льности
сельхозтехнологи=сельхозтехно+логи
анимированные=аними+рованные
мультисигнатура=мультисигнату+ра
консеквенции=консекве+нции
выигрываю=выи+грываю
неславную=несла+вную
фэйковые=фэ+йковые
адоптацию=адопта+цию
криптоинвестиций=криптоинвести+ций
православный=правосла+вный
расстояние=расстоя+ние
социального=социа+льного
раидиошоу=раидиошо+у
майлстоуны=майлсто+уны
криптозиму=криптози+му
криптоуслуг=криптоуслу+г
объединять=объединя+ть
впечатлены=впечатлены+
интересную=интере+сную
удасться=уда+сться
недвижимостные=недви+жимостные
стейкинг=сте+йкинг
защищённей=защищё+нней
богато=бога+то
приобретённая=приобретё+нная
акционировать=акциони+ровать
стейкера=сте+йкера
программ=програ+мм
снатвот=снатво+т
аккаунтинг=акка+унтинг
происходит=происхо+дит
брендирования=бренди+рования
нетфликс=не+тфликс
криптосфере=криптосфе+ре
уверена=уве+рена
платёжных=платё+жных
автокликеры=автокли+керы
настороженно=насторо+женно
вебсайтами=вебса+йтами
криптофонда=криптофо+нда
слушатели=слу+шатели
преодолеваются=преодоле+ваются
метадату=метада+ту
неопекаемые=неопека+емые
финанс=фина+нс
криптокредитор=криптокредито+р
существует=существу+ет
актёров=актё+ров
многоплатформенной=многоплатфо+рменной
сервисах=с+ервисах
литигации=литига+ции
индией=и+ндией
заметочник=заме+точник
ритейловые=рите+йловые
стейкинги=сте+йкинги
дневной=дневно+й
аркадная=арка+дная
криптомайнинга=криптома+йнинга
мультитехнологии=мультитехноло+гии
бомбезно=бомбе+зно
фэйков=фэ+йков
сверхдостижения=сверхдостиже+ния
дюймового=дюймо+вого
конкурентоспособным=конкурентоспосо+бным
стейкинге=сте+йкинге
нелицензионные=нелицензио+нные
чатботом=чатбо+том
однокликовые=однокли+ковые
низкозатратные=низкозатра+тные
предзаказать=предзаказа+ть
коммуникации=коммуника+ции
озвучиваю=озву+чиваю
консолями=конс+олями
криптоэкосистеме=криптоэкосисте+ме
гелсайд=гелса+йд
ветром=ве+тром
сбалансирована=сбаланси+рована
менеджмент=менеджме+нт
криптоакции=криптоа+кции
актёры=актё+ры
токенизированного=токенизи+рованного
деривативным=деривати+вным
гейминг=ге+йминг
искусственным=иску+сственным
продуктивного=продукти+вного
сверхъестественными=сверхъесте+ственными
укладываться=укла+дываться
честно=че+стно
чатботами=чатбо+тами
мемекоиновы=мемекои+новы
ядрёном=ядрё+ном
чрнить=чрни+ть
экологичнее=экологи+чнее
оффер=о+ффер
мультиблокчейна=мультиблокче+йна
реюньон=реюньо+н
криптофирмы=криптофи+рмы
улыбаешься=улыба+ешься
мулан=мула+н
фиатные=фиа+тные
фиатный=фиа+тный
криптообменник=криптообме+нник
мухоморный=мухомо+рный
оценён=оценё+н
нафармили=нафа+рмили
чатботах=чатбо+тах
увлечены=увлечены+
автоархивации=автоархива+ции
крипто=кри+пто
аналогична=аналоги+чна
разводнять=разводня+ть
протестированы=протести+рованы
многомиллионной=многомиллио+нной
обозревательный=обозрева+тельный
криптосферы=криптосфе+ры
рассматривать=рассма+тривать
криптоплатежей=криптоплатеже+й
стейкинговых=сте+йкинговых
геймерша=ге+ймерша
обман=обма+н
микромобильные=микромоби+льные
домашний=дома+шний
внутрибиржевой=внутрибиржево+й
размер=разме+р
плейлистов=плейлисто+в
криптокредитором=криптокредито+ром
будете=бу+дете
широких=широ+ких
оценятся=оце+нятся
компрессировать=компресси+ровать
инфлюенсеры=инфлюе+нсеры
лендерами=ле+ндерами
криптомира=криптоми+ра
криптотрейдинга=криптотре+йдинга
важная=ва+жная
прибегание=прибега+ние
криптоинвестициям=криптоинвести+циям
фиатным=фиа+тным
сейчас=сейча+с
гиперболизировали=гиперболизи+ровали
готовиться=гото+виться
марафон=марафо+н
забочусь=забо+чусь
таких=таки+х
макро=ма+кро
припев=припе+в
заспамили=заспа+мили
инфлюэнсеров=инфлюэ+нсеров
снапчате=снапча+те
неанонсированного=неанонси+рованного
токенизированных=токенизи+рованных
локальной=лока+льной
фичой=фичо+й
мультиподписных=мультиподписны+х
ежедневным=ежедне+вным
спрашивал=спра+шивал
криптоинвестиционные=криптоинвестицио+нные
привержен=приве+ржен
чатботам=чатбо+там
бинанс=бина+нс
необоротной=необоро+тной
киберэкспертом=киберэкспе+ртом
выигрыш=вы+игрыш
аутентичности=аутенти+чности
криптобум=криптобу+м
конкурентноспособное=конкурентноспосо+бное
нераспознаваемыми=нераспознава+емыми
желанный=жела+нный
мультиблокчейн=мультиблокче+йн
невзаимозаменяемыми=невзаимозаменя+емыми
роботической=роботи+ческой
присоединяются=присоединя+ются
метавселенных=метавселе+нных
обагащённые=обагащё+нные
развитии=разви+тии
предоплаченные=предопла+ченные
незастрахованными=незастрахо+ванными
контрпартийного=контрпарти+йного
невыплачиваемые=невыпла+чиваемые
натренированных=натрени+рованных
равенства=ра+венства
евангелистов=евангели+стов
кастомизированным=кастомизи+рованным
теханализ=техана+лиз
вдохновляюще=вдохновля+юще
лендеры=ле+ндеры
протестировано=протести+ровано
криптоинвестирование=криптоинвести+рование
криптостартапами=криптостарта+пами
радиоузлам=радиоузла+м
призадумался=призаду+мался
неядрёные=неядрё+ные
электроисточник=электроисто+чник
телесные=теле+сные
футбольную=футбо+льную
мультиплеерные=мультипле+ерные
невзаимозаменяемых=невзаимозаменя+емых
криптобизнесе=криптоби+знесе
неконтролированные=неконтроли+рованные
многогранный=многогра+нный
робототакси=робототакси+
криптоинвесторам=криптоинве+сторам
малопрозрачной=малопрозра+чной
засыплют=засыплю+т
роботическим=роботи+ческим
необыкновенно=необыкнове+нно
деривативные=деривати+вные
созданного=со+зданного
европейский=европе+йский
криптообласти=криптоо+бласти
демоплатформа=демоплатфо+рма
криптобизнеса=криптоби+знеса
криптоинвесторы=криптоинве+сторы
займа=за+йма
криптофирм=криптофи+рм
работник=рабо+тник
криптоинвестиции=криптоинвести+ции
фотографиями=фотогра+фиями
слежу=слежу+
плейлист=плейли+ст
отслеживаемость=отсле+живаемость
партнёров=партнё+ров
кинофестиваль=кинофестива+ль
сабрина=сабри+на
татьянушка=татья+нушка
находится=нахо+дится
адаптирование=адапти+рование
деривативная=деривати+вная
криптонаградами=криптонагра+дами
клиентоориентированным=клиентоориенти+рованным
современные=совреме+нные
поржём=поржё+м
объяснить=объясни+ть
криптоинвестированию=криптоинвести+рованию
необанков=необа+нков
некомфортности=некомфо+ртности
криптозима=криптозима+
дублёров=дублё+ров
бесчерепные=бесчерепны+е
когтиками=ко+гтиками
криптофирмам=криптофи+рмам
криптокредитора=криптокредито+ра
скалирования=скали+рования
удалёнке=удалё+нке
эмиссионными=эмиссио+нными
ромушка=ро+мушка
криптовалютообразование=криптовалютообразова+ние
анти=а+нти
брендирование=бренди+рование
прошествующего=проше+ствующего
предусматривать=предусма+тривать
мессенджеры=ме+ссенджеры
криптофирмами=криптофи+рмами
персональности=персона+льности
локдауна=локда+уна
инфлюенсерах=инфлюе+нсерах
незастрахованные=незастрахо+ванные
деривативные=деривати+вные
программами=програ+ммами
антиотмывания=антиотмыва+ния
автоархивирующую=автоархиви+рующую
находиться=находи+ться
реферальные=рефера+льные
рассудительности=рассуди+тельности
зеленским=зеле+нским
хостелы=хо+стелы
смартфон=смартфо+н
скам=ска+м
чекаута=чека+ута
поживём=поживё+м
рассержена=рассе+ржена
включённости=включё+нности
контроля=контро+ля
краткосрочную=краткосро+чную
рискованно=риско+ванно
наоборот=наоборо+т
продукт=проду+кт
вызывной=вызывно+й
криптомаркете=криптома+ркете
супервизионных=супервизио+нных
невзаимозаменяемые=невзаимозаменя+емые
неэмоциональной=неэмоциона+льной
очно=о+чно
криптобанков=криптоба+нков
плейлисты=плейлисты+
финанса=фина+нса
медвежатами=медвежа+тами
услуг=услу+г
оригинальных=оригина+льных
неодобренных=неодо+бренных
значении=значе+нии
дискуссий=диску+ссий
заблокированию=заблоки+рованию
метавиртуального=метавиртуа+льного
метавселенной=метавселе+нной
мультитехнологию=мультитехноло+гию
может=мо+жет
беременные=бере+менные
детализировано=детализи+ровано
удовлетворяюще=удовлетворя+юще
оппозиционировать=оппозициони+ровать
беспредельно=беспреде+льно
майлстоунах=майлсто+унах
криптостартапов=криптостарта+пов
криптоинвестировании=криптоинвести+ровании
контракты=контра+кты
криптомаркет=криптома+ркет
протестирован=протести+рован
метавселенные=метавселе+нные
секретный=секре+тный
защищённее=защищё+ннее
пинтереста=пинтере+ста
заработке=за+работке
дискуссии=диску+ссии
культистов=культи+стов
электромоторчик=электромото+рчик
позолачивать=позола+чивать
строитель=строи+тель
сториз=сто+риз
депозитит=депози+тит
изменяющийся=изменя+ющийся
миллиардного=миллиа+рдного
стейкхолдеров=стейкхо+лдеров
придёт=придё+т
крафтить=кра+фтить
дневное=дневно+е
франкенштейна=франкенште+йна
конкурентный=конкуре+нтный
борются=бо+рются
криптомиру=криптоми+ру
надеются=наде+ются
впечатлена=впечатлена+
подорбитальный=подорбита+льный
сверхспособ=сверхспо+соб
геймерш=ге+ймерш
мультисигнатурные=мультисигнату+рные
бэкапная=бэка+пная
фиатная=фиа+тная
автокликерами=автокли+керами
регуляции=регуля+ции
тихоновой=ти+хоновой
реддите=ре+ддите
необновлённой=необновлё+нной
чатботу=чатбо+ту
контракторам=контра+кторам
запрещающие=запреща+ющие
противник=проти+вник
био=би+о
снапчат=снапча+т
купчино=ку+пчино
нужно=ну+жно
иначе=ина+че
должно=должно+
глубоко=глубоко+
наверх=наве+рх
верно=ве+рно
судя=су+дя
кафе=кафе+
страшно=стра+шно
широко=широко+
скучно=ску+чно
назубок=назу+бок
полно=полно+
светло=светло+
здорово=здо+рово
утру=утру+
колет=ко+лет
кэшбек=кэшбе+к
хлебов=хлебо+в
