a=э
abakan=абака+н
abarth=аба+рт
abbyy=а+бби
abyss=аби+с
able=эйбл
about=эба+ут
above=эба+в
abracadabra=абракада+бра
absolut=абсолю+т
absolute=э+бсолют
academy=акэ+дэми
acapela=акапэ+ла
acceleration=акселерэ+йшен
accent=аксэ+нт
accept=аксэ+пт
access=аксэ+с
accessibility=аксэсиби+лити
accident=э+ксидэнт
accord=акко+рд
account=акка+унт
accueil=акё+й
accurate=э+кьюрэт
accuse=акью+з
ace=э+йс
acer=э+йсер
acoustic=аку+стик
acrobat=акроба+т
actimel=актимэ+ль
action=э+кшэн
activate=активэ+йт
active=э+ктив
activist=э+ктивист
activision=активи+жен
activity=акти+вити
acura=аку+ра
adams=а+дамс
add=эд
addition=адди+шэн
address=эдрэ+с
addressbook=эдрэсбу+к
adidas=адида+с
adieu=адью+
adieux=адью+
adjust=аджа+ст
admin=адми+н
administrate=адми+нистрэйт
administration=администрэ+йшн
administrator=администрэ+йтор
admit=адми+т
adobe=эдо+б
adopt=адо+пт
adria=а+дрия
adsense=адсэ+нс
adult=эда+лт
advance=эдва+нс
advanced=адва+нст
advantage=адва+нтэдж
adventure=адвэ+нче
advertise=адверта+йз
advertisement=адвё+ртисмент
advice=эдва+йс
adviser=адва+йзэр
advisor=адва+йзор
aegis=и+джис
aero=а+эро
aeroflot=аэрофло+т
aeromexico=аэроме+ксико
aeronautica=аэрона+утика
aeronautics=эроно+тикс
aeroport=аэропо+рт
aerosmith=аэрасми+т
aerospace=аэроспэ+йс
aerosvit=аэросви+т
aerosystems=аэроси+стэмс
affair=эфэ+йр
afghan=афга+н
afghanistan=афганиста+н
afisha=афи+ша
afraid=эфрэ+йд
africa=а+фрика
african=э+фрикан
afriqiyah=африки+я
after=а+фтэр
afternoon=афтэрну+н
afterparty=афтэрпа+ти
again=эгэ+йн
against=эгэ+йнст
age=эйдж
agence=ажа+нс
agency=э+йдженси
agenda=адже+нда
agent=э+йджент
agile=э+джил
agnitio=агни+тио
ago=эго+у
agree=агри+
agricole=агрико+ль
aguilera=агиле+ра
ahead=эхэ+д
ahronot=ахроно+т
ahronoth=ахроно+т
air=э+йр
airbaltic=эйрба+лтик
airberlin=эйрберли+н
airblue=эйрблю+
airbus=эйрба+с
airchina=эйрча+йна
aircraft=э+йркрафт
aires=а+йрэс
aireuropa=эйръевро+па
airfrance=эрфра+нс
airline=э+йрлайн
airmail=эйрмэ+йл
airmalta=эйрма+льта
aironet=эйронэ+т
airplane=э+арплэйн
airport=эйрпо+рт
airsure=эйршу+э
airunion=эйръю+нион
airways=э+йрвэйз
airzena=эйрзэ+на
ajax=ая+кс
akademicheskaya=академи+ческая
akbars=акба+рс
akpet=акпе+т
aktiengesellschaft=акциэнгезэ+льшафт
aktuell=актуэ+ль
al=ал
alabama=алаба+ма
alan=э+лан
alanis=ала+нис
alarm=ала+рм
alaska=аля+ска
albany=о+лбани
albert=а+льберт
albertina=альберти+на
albion=э+лбион
album=э+лбум
albuquerque=албукэ+ркэ
alcatel=алкатэ+ль
alcatraz=алькатра+с
alco=э+лко
alcoa=алко+а
alcohol=э+лкохол
aldemar=альдэма+р
alebedev=але+бедев
alec=а+лек
alejandro=алеха+ндро
alex=а+лекс
alexander=алекса+ндр
alexandr=алекса+ндр
alexandra=алекса+ндра
alfa=а+льфа
alfabank=альфаба+нк
alfred=а+льфрэд
algebra=э+лджэбра
algebraic=элджэбрэ+ик
algerie=алжери+
algiers=алджи+рз
ali=али+
alias=э+йлиас
alibaba=алибаба+
alice=э+лис
alicia=али+шиа
align=эла+йн
alignment=эла+йнмент
alike=эла+йк
alitalia=алита+лиа
alive=эла+йв
alkali=э+лкалай
all=ол
allbooks=олбу+кс
allbusiness=олби+знэс
allegation=алэгэ+йшен
alleged=алэ+джд
allende=алье+ндэ
allentown=аллента+ун
allgemeine=альгема+йнэ
alliance=эла+йанс
allianz=алья+нс
allion=а+лион
allmusic=олмью+зик
allophone=э+ллофон
allowance=эла+уэнс
allright=олра+йт
alma=а+льма
almaty=алматы+
almera=алме+ра
almost=о+лмост
alone=эло+ун
aloud=эла+уд
alpha=а+льфа
alphaville=альфави+ль
alpine=э+лпайн
alps=э+лпс
alright=олра+йт
alrosa=алро+са
alsace=эльза+с
also=о+лсо
alt=альт
altavista=альтави+ста
altaysb=алтайэсбэ+
alte=а+льтэ
altea=альтэ+а
alter=а+льтэр
alternative=алтэ+рнатив
altimo=а+лтимо
altogether=олтугэ+зэр
altsb=алтэсбэ+
always=о+лвэйз
am=эм
amanda=ама+нда
amateur=э+матэр
amazing=амэ+йзинг
amazon=амазо+н
ambiance=э+мбианс
ambience=э+мбианс
ambition=амби+шын
ambitious=амби+шес
america=аме+рика
american=амэ+рикан
americana=амэрика+на
americano=амэрика+но
ameriprise=амэрипра+йз
amma=а+мма
amnesty=э+мнысти
amoled=амоле+д
among=эма+нг
amongst=эма+нгст
amor=амо+р
amos=а+мас
amour=аму+р
amsterdam=амстэрда+м
amur=аму+р
amuse=амью+з
amy=э+ми
an=эн
analog=э+нэлог
analogue=э+нэлог
analysis=анэ+лисис
analytic=анали+тик
analytical=анали+тикал
anandtech=анандтэ+к
ananova=анано+ва
anapa=ана+па
anarchy=э+нарки
ancestry=э+нсэстри
anchorage=э+нкоридж
ancient=э+йншент
and=энд
andalusia=андалу+сия
andersen=а+ндерсен
anderson=а+ндерсон
andes=э+ндиз
andizhan=андижа+н
andorra=андо+ра
andrew=э+ндрю
android=андро+ид
anecho=анэ+хо
anekdot=анекдо+т
angel=э+нджел
angeles=э+нджэлес
anglaise=англэ+з
anima=а+нима
animal=э+нимал
animation=анимэ+йшен
anime=анимэ+
anjou=анжу+
ann=эн
anna=а+нна
annapolis=ана+полис
anne=эн
annick=ани+к
announcement=эна+унсмэнт
annoy=эно+й
annoyance=ано+енс
annual=э+ньюал
anonymous=ано+нимас
another=эна+зэр
answer=а+нсэр
antananarivo=антананари+ву
anthony=э+нтони
anthropologist=антропо+лоджист
anthropology=антропо+лоджи
anti=а+нти
antigua=анти+гуа
antilles=анти+лиз
antofagasta=антофага+ста
antoine=антуа+н
antonio=анто+нио
antony=э+нтани
antwerp=э+нтверп
anxiety=энза+йэти
anxious=э+нкшэс
anybody=э+нибади
anyhow=эниха+у
anyone=э+ниван
anything=э+нисынг
anywhere=э+нивэр
apache=апа+чи
apart=апа+рт
aphrodite=афро+дитэ
apocalypse=апо+калипс
apocalypto=апокали+пто
apollo=апо+лло
aport=апо+рт
appear=эпи+эр
applaud=апло+д
applause=апло+з
apple=эпл
applet=апле+т
application=апликэ+йшэн
applied=апла+йд
approach=апро+ч
approximately=апро+ксимэтли
appstars=апста+рс
appstore=эпсто+р
april=э+йприл
aqua=а+ква
aquascutum=акваску+тум
aquila=а+квила
arabia=ара+биа
arabiya=араби+я
arbat=арба+т
arcanoid=аркано+ид
arcelor=арсело+р
arcelormittal=арселорми+ттал
archduke=арчдью+к
architect=а+ркитэкт
architecture=аркитэ+кчар
architectural=аркитэ+кчарал
archive=арка+йв
ardennes=ардэ+н
ardo=а+рдо
are=ар
area=э+реа
arenda=аре+нда
argentina=аджэнти+на
argue=а+ргью
argument=а+ргьюмэнт
arial=э+риал
ariana=ариа+на
ariston=аристо+н
arizona=аризо+на
arkansas=арканза+с
armand=арма+н
armani=арма+ни
armavia=арма+виа
armenia=арме+ния
armenian=арми+ниан
armstrong=а+рмстронг
around=эра+унд
arpels=а+рпельс
arrandale=арандэ+йл
arrange=арэ+ндж
arranger=арэ+нджер
arrow=э+роу
arsenal=а+рсэнал
art=арт
arte=а+ртэ
artek=артэ+к
arthouse=артха+ус
arthur=а+ртур
article=а+ртикл
artificial=артифи+шыл
artist=а+ртист
artlebedev=артле+бедев
artois=артуа+
arxiv=архи+в
as=эз
ascend=асэ+нд
ashamed=эше+ймд
ashkhabad=ашхаба+д
asia=э+йжа
asian=э+йжан
ask=аск
aspire=эспа+йр
assange=аса+нж
assault=асо+лт
assemble=асэ+мбл
assign=асса+йн
assigned=асса+йнд
assist=аси+ст
assistance=аси+станс
associate=асо+шиэйт
associated=асошиэ+йтыд
association=асосиэ+йшэн
astana=астана+
asterisk=астэри+ск
aston=а+стон
astra=а+стра
astronomical=астроно+микал
astronomy=астро+номи
astrophysical=астрофи+зикал
astrophysics=астрофи+зикс
asuncion=асунсьо+н
asus=а+сус
asustek=асустэ+к
asynchronous=асинхро+нус
at=эт
atelier=ателье+
athens=э+синз
athlon=атло+н
atlanta=атла+нта
atlantic=атла+нтик
atlantis=атла+нтис
atmosphere=э+тмосфир
atom=а+том
atomic=ато+мик
atrix=а+трикс
attach=атта+ч
attachment=атта+чмэнт
attack=атэ+к
attempt=этэ+мпт
attention=атэ+ншэн
attentive=атэ+нтив
attract=атрэ+кт
attraction=атрэ+кшын
attractive=атрэ+ктив
attribution=атрибью+шэн
auburn=о+бэрн
auchan=аша+н
auction=о+кшэн
audi=а+уди
audio=а+удио
audit=ауди+т
auf=а+уф
august=о+гэст
augusta=ога+ста
aunt=ант
aurelio=аурэ+лио
auris=а+урис
aurora=авро+ра
austin=о+стин
australia=острэ+лиа
australian=острэ+лиан
austria=о+стриа
austrian=о+стриан
author=о+сэр
auto=а+вто
autobahn=автоба+н
autobild=автоби+лд
autocad=автока+д
autocar=автока+р
autocenter=автосэ+нтэр
autoexe=аутоэкзэ+
autoforum=автофо+рум
autokassa=автока+сса
automatic=отомэ+тик
automatical=отомэ+тикал
automatically=отомэ+тикали
automobile=отомоби+л
automotive=автомо+тив
autonavigator=автонавига+тор
autonews=автонью+з
autonomy=ото+номи
autoplay=автоплэ+й
autoramber=автора+мблер
autoreview=авторевью+
autorun=автора+н
autumn=о+тэм
available=эвэ+йлабэл
avalon=авало+н
avatar=авата+р
avaya=ава+йя
avensis=аве+нсис
avenue=э+венью
average=э+вирадж
avia=а+виа
avianova=авиано+ва
aviashop=авиашо+п
aviation=авиэ+йшэн
avidius=ави+диус
avignon=авиньо+н
avis=а+вис
avoid=эво+йд
avon=э+йвон
avril=аври+л
avto=а+вто
avtovaz=автова+з
awake=эвэ+йк
award=аво+рд
awareness=авэ+рнэс
away=эвэ+й
awesome=о+сом
awkward=о+квэрд
axe=экс
axio=а+ксио
axiom=э+ксиом
azerbaycan=азербайджа+н
baboushka=ба+бушка
babushka=ба+бушка
baby=бэ+йби
baccarat=бакара+
bacchiani=бакиа+ни
bach=бах
back=бэк
background=бэкгра+унд
backstage=бэкстэ+йдж
backstreet=бэкстри+т
backward=бэ+квард
bad=бэд
bada=ба+да
baggage=бэ+гидж
bahamas=бага+мас
bahnhof=ба+нхоф
bahnhofe=ба+нхофэ
bahnhofstrasse=банхофштра+сэ
bahrain=бахрэ+йн
baidu=ба+йду
baker=бэ+йкер
baku=баку+
balance=бэ+лэнс
balenciaga=баленсиа+га
ball=бол
ballad=бэ+лад
ballerina=балери+на
ballet=балэ+й
balt=балт
baltbank=балтба+нк
baltic=ба+лтик
baltimore=ба+лтимор
baltinfo=балтинфо+
bamboo=бамбу+
banco=ба+нко
band=бэнд
bang=бэнг
bangkok=банко+к
bangui=банги+
banjul=банджу+л
bank=банк
banka=ба+нка
bankcorp=банкко+рп
banker=бэ+нкэр
bankia=ба+нкиа
bankir=банки+р
bankuralsib=банкуралси+б
banksouz=банксою+з
banner=ба+ннэр
banque=банк
barack=бара+к
baraholka=барахо+лка
barber=ба+рбэр
barbican=ба+рбикан
barbie=ба+рби
barcelona=барсело+на
barclays=баркла+йс
barcode=барко+д
bargain=ба+ргин
barnes=ба+рнс
barneys=ба+рнис
barracuda=барраку+да
barrel=ба+рэл
barrier=барье+р
barrueco=барруэ+ко
barvikha=барви+ха
base=бэйз
baseball=бейсбо+л
based=бэйзд
basel=ба+зэль
bash=баш
basic=бэ+йсик
basin=бэ+йсин
basis=бэ+йсис
basket=ба+скет
basketball=бэ+скетбол
baskin=ба+скин
basque=баск
bathe=бэйз
baton=ба+тон
battery=бэ+тэри
batumi=бату+ми
bau=ба+у
bauhaus=бауха+ус
baw=ба+у
bayer=ба+йер
bayern=ба+йерн
bazaar=база+р
bazar=база+р
be=би
beach=бич
bear=бэ+ар
beastie=би+сти
beat=бит
beatles=битлз
beau=бо
beaujolais=божоле+
beaumont=бо+монт
beaute=ботэ+
beautiful=бью+тифул
beauty=бью+ти
became=бикэ+йм
because=бико+з
become=бика+м
beefsteak=би+фстэйк
beeline=била+йн
been=бин
beer=би+эр
beetle=би+тл
before=бифо+р
began=бегэ+н
begin=беги+н
beginning=беги+нинг
begun=бига+н
behave=бихэ+йв
behavior=бихэ+йвиэр
behaviour=бихэ+йвиэр
behind=биха+йнд
behold=бихо+лд
beige=беж
beijing=бейджи+н
being=би+инг
beirut=бейру+т
belarus=белару+сь
belavia=бела+виа
belgium=бэ+лджиум
belgorod=бе+лгород
belgrade=белгра+д
believe=бели+в
belinea=бели+нэа
belle=бэль
belmopan=бельмопа+н
belong=било+нг
belorechenskaya=белоре+ченская
belvedere=бельведэ+р
ben=бэн
benefit=бэ+нэфит
benelli=бэнэ+ли
benetton=бенетто+н
benois=бенуа+
bentley=бэ+нтли
benz=бэнц
beonline=бионла+йн
berkeley=бэ+ркли
berlin=берли+н
bermejo=бермэ+хо
bershka=бе+ршка
besame=бэ+самэ
besides=биса+йдз
best=бэст
besturn=бэсту+рн
bethlehem=бе+тлехем
better=бэ+тэр
between=битви+н
beverage=бэ+вэридж
beverly=бэ+вэрли
beyer=ба+йэр
beyerdynamic=байэрдайнэ+мик
beyonce=биё+нсэ
beyond=биё+нд
bhutan=бута+н
bias=ба+йас
biathlon=биатло+н
bible=байбл
bibliotheca=библиоте+ка
bibliotheque=библиотэ+к
bicycle=ба+йсикл
bien=бьен
biennale=биена+ле
bientot=бьенто+
bier=бир
big=биг
biglion=биглио+н
bijou=бижу+
bijoux=бижу+
bike=байк
bilbao=бильба+о
bild=бильд
bilingua=били+нгва
bill=бил
billboard=билбо+рд
billing=би+линг
billion=би+лион
billionaire=би+лионэр
billionnaire=би+лионэр
binatone=бинато+н
binbank=бинба+нк
bio=би+о
biology=байо+лоджи
biomarker=биома+ркер
biometric=байомэ+трик
biopic=байопи+к
bios=би+ос
bioshock=биошо+к
biotherm=биотэ+рм
bird=бёрд
birmingham=би+рмингем
birobidzhan=биробиджа+н
birthday=бё+здэй
bismarck=би+смарк
biscuit=би+скит
bissau=биса+у
bistro=бистро+
bistrot=бистро+
bit=бит
bizkit=би+скит
black=блэк
blackberry=блэ+кбэри
blackboard=блэ+кборд
blackrock=блэкро+к
blade=блэйд
blair=блэр
blanc=бланк
blanche=бланш
blancpain=бланпа+
bleu=блё
blige=бла+йдж
blind=блайнд
blizzard=бли+зард
block=блок
blockbuster=блокба+стэр
bloemfontein=блу+мфонтэйн
blogspot=блогспо+т
blondie=бло+нди
blood=блад
bloody=бла+ди
blu=блю
blue=блю
blueberry=блю+бэри
bluecore=блюко+р
bluetooth=блюту+с
blur=блё+р
bobois=бобуа+
body=бо+ди
boeing=бо+инг
boerse=бё+рсэ
bogdan=богда+н
bogota=богота+
boise=бо+йс
bold=болд
bolshaya=больша+я
bolzano=больца+но
bomb=бом
bombardier=бомбардье+р
bon=бо+н
bond=бонд
bonjour=бонжу+р
boogie=бу+ги
bookinhotels=букинхотэ+лс
boomerang=бумера+нг
bora=бо+ра
bordeaux=бордо+
border=бо+рдэр
born=бо+рн
borrow=бо+роу
borussia=бору+ссия
bosch=бош
bosco=бо+ска
bosh=бош
bosnia=бо+сния
boss=бос
boston=бо+стан
both=бос
bother=бо+зэр
boucheron=бушеро+н
bought=бот
boulogne=було+нь
boundary=ба+ундэри
bounty=ба+унти
bourgeois=буржуа+
boutique=бути+к
bowie=бо+уи
bowl=бо+ул
box=бокс
boy=бо+й
boyfriend=бо+йфрэнд
boys=бо+йз
boyzone=бойзо+н
brainstorm=брэйнсто+рм
branch=бранч
brand=брэнд
bratislava=братисла+ва
braun=бра+ун
braunschweig=бра+уншвейг
bravery=брэ+йвэри
bravia=бра+виа
bravo=бра+во
braxton=брэ+кстан
brazil=брази+л
brazzaville=бразави+ль
bread=брэд
breadth=брэдс
break=брэйк
breakfast=брэ+кфэст
breast=брэст
breath=брэс
breathe=бриз
breguet=брэге+
brent=брэнт
brescia=бре+шиа
brian=бра+йан
bribe=брайб
bribery=бра+йбэри
bridesmaid=бра+йдсмэйд
bridge=бридж
bridgeport=бри+джпорт
bridgetown=бриджта+ун
brightness=бра+йтнэс
brilliance=бри+лианс
brilliant=бри+лиант
brionvega=брионвэ+га
britain=бри+тан
britannia=брита+ния
britannica=брита+ника
british=бри+тиш
britney=бри+тни
broadband=бро+дбэнд
broadcast=бро+дкаст
broadcom=бродко+м
broadway=бродвэ+й
broke=бро+ук
bronnaya=бро+нная
bronze=бронз
brother=бра+зэр
brotherhood=бра+зэрхуд
brought=брот
brown=бра+ун
browse=бра+уз
browser=бра+узэр
brugge=брю+гге
bruni=бруни+
brush=браш
brussels=бра+ссэлс
bruxelles=брюссэ+ль
bryan=бра+ин
buchanan=бью+кэнэн
bucharest=бухаре+ст
bucket=ба+кит
budapest=будапе+шт
buddha=бу+дда
buena=буэ+на
bueno=буэ+но
buffalo=ба+фало
bug=баг
bugatti=буга+тти
bugzilla=багзи+ла
buick=бью+ик
build=билд
built=билт
bulgari=булга+ри
bulgaria=болга+рия
bulgarian=балгэ+риан
bull=бул
bullet=бу+лит
bulletin=бу+летин
burberry=бё+рбэри
bureau=бью+ро
burg=бург
burgerking=бургерки+нг
burlington=бё+рлингтон
burma=би+рма
burn=бёрн
burst=бёрст
bush=буш
business=би+знэс
businesslike=бизнэсла+йк
businessman=бизнэсмэ+н
businessweek=бизнэсви+к
busted=ба+стэд
busy=би+зи
but=бат
butcher=бу+чер
buy=бай
buzz=баз
bvlgari=булга+ри
by=бай
bydgoszcz=бы+дгощ
bye=бай
c'est=сэ
cabernet=кабернэ+
cabin=кэ+бин
cable=кэйбл
cacharel=кашарэ+ль
cadbury=кэ+дбэри
cadet=каде+т
cadett=каде+т
cadillac=кадилла+к
caesar=си+зар
cafe=кафэ+
cahiers=кайе+р
cahul=кагу+л
calculation=калкьюлэ+йшын
calculator=калкьюлэ+йтор
california=калифо+рния
call=кол
caller=ко+лэр
calvin=кэ+лвин
calzedonia=кальцедо+ния
camaro=кама+ро
cambodia=камбо+джа
cambridge=кэ+мбридж
camedia=каме+диа
camel=кэ+мэл
camera=ка+мера
cameron=кэ+мерон
camille=ками+л
campaign=кампэ+йн
camry=ка+мри
canada=кэ+нада
canadian=канэ+диан
canal=кана+л
cancellation=кансэлэ+йшэн
candidate=кэ+ндидэт
candy=кэ+нди
cannes=канн
canon=кэ+нон
canyon=кэ+нион
capernaum=каперна+ум
capital=кэ+питал
cappella=капэ+лла
caps=капс
capslock=капсло+к
captain=кэ+птэн
carcassonne=каркасо+н
card=кард
care=кэ+ар
career=кари+р
carey=кэ+ри
cargo=ка+рго
caribbean=кэриби+ан
carisma=кари+зма
caritas=ка+ритас
carla=ка+рла
carmina=ка+рмина
carnival=ка+рнивал
carolina=кэрола+йна
carpenter=ка+рпэнтэр
carphone=карфо+н
carriage=кэ+ридж
carry=кэ+рри
carscoop=ка+рскуп
carson=ка+рсон
cartier=картье+
cartoon=карту+н
casablanca=касабла+нка
casanova=казано+ва
case=кейс
cash=кэш
casino=казино+
casio=ка+сио
caspian=ка+спиан
cast=каст
castelbajac=кастэльбажа+к
castilla=касти+лья
castle=касл
castorama=кастора+ма
casual=кэ+жуал
casualty=кэ+жуалти
catalina=катали+на
catalog=катало+г
catalogue=катало+г
catalunya=каталу+нья
catch=кэч
category=кэ+тегори
caterpillar=катэрпи+лар
catherine=кэ+трин
cathode=като+д
catholic=кэ+толик
cathy=кэ+ти
caucasus=ко+кэсис
caught=кот
caution=ко+шэн
cautious=ко+шэс
caviar=кэвиа+р
cayenne=кайе+нн
cebit=це+бит
celebrate=сэ+лэбрэйт
celebration=сэлэбрэ+йшен
celeron=селеро+н
celica=цэ+лика
celine=сили+н
cell=сэл
cellspacing=сэлспэ+йсинг
cellular=сэ+льюлар
center=сэ+нтэр
central=сэ+нтрал
centre=сэ+нтэр
century=сэ+нчери
ceremony=сэ+ремони
certain=сё+ртэйн
certainty=сё+ртэнти
certificate=серти+фикэт
cerveza=сэрвэ+са
cetera=сэ+тэра
chalk=чок
challenge=че+лендж
challenger=че+ленджер
chamber=че+ймбэр
chamberlain=че+мбэрлэн
chambre=шамбр
chambres=шамбр
champagne=шампа+нь
championat=чемпиона+т
chana=ча+на
chanel=шанэ+ль
change=че+йндж
changfeng=чангфэ+нг
channel=че+нэл
chao=ча+о
character=кэ+рэктэр
chardonnay=шардонэ+
chariot=че+риот
charity=че+рити
charles=чарльз
charleston=ча+рлстон
charter=ча+ртэр
chat=чат
chateau=шато+
chatelet=шатлэ+
chaumet=шомэ+
check=чек
chemical=кэ+микал
chemist=кэ+мист
chemistry=кэ+мистри
cher=шэ+р
cherbourg=шербу+р
chere=шэ+р
cherie=шери+
cherokee=чиро+ки
chery=че+ри
cherry=че+ри
chesterfield=че+стэрфилд
chevrolet=шевроле+
chevron=шевро+н
cheyenne=шайе+н
chicago=чика+го
chicks=чи+кс
chihuahua=чихуа+хуа
child=чайлд
children=чи+лдрэн
chile=чи+ли
chili=чи+ли
chimney=чи+мни
china=ча+йна
chinamobil=чайнамо+бил
chinese=чайни+з
chinju=чинджу+
chinook=чину+к
chloe=клоэ+
chocolate=чо+колат
choir=куа+йр
chomolungma=джомолу+нгма
chongqing=чунци+н
choose=чуз
chopard=шопа+р
chorus=ко+рус
chosen=чо+узн
chris=кри+с
chrisler=кра+йслер
christ=крайст
christian=кристиа+н
christie=кри+сти
christie's=кри+стис
christina=кристи+на
christmas=кри+смас
christopher=кри+стофер
chrome=хром
chronicle=кро+никл
chronograph=хроно+граф
chrysler=кра+йслер
church=чёрч
cigarette=си+гарэт
ciliegi=чилье+джи
cincinnati=цинцина+ти
cinderella=синдирэ+лла
cinecitta=чинэчита+
cinema=си+нима
cinemascope=синимаско+п
cipriani=чиприа+ни
circa=си+рка
circuit=сё+ркит
circular=сё+ркьюлар
circulation=сэркьюлэ+йшен
circus=сё+ркус
cirque=сирк
cirrus=си+ррус
cisco=си+ско
citi=си+ти
citibank=ситиба+нк
citicorp=ситико+рп
citigroup=ситигру+п
citizen=си+тизэн
citrix=си+трикс
citroen=ситроэ+н
city=си+ти
civic=ци+вик
civilize=си+вилайз
claire=клэр
clarins=кла+ринс
clarkdale=кларкдэ+йл
class=кла+с
classic=кла+сик
classica=кла+сика
classical=кла+сикал
classification=класификэ+йшын
classified=класифа+йд
classify=класифа+й
classmate=кла+смэйт
claudio=кла+удио
claus=кла+ус
clean=клин
cleaner=кли+нэр
clear=кли+ар
clearquest=клиарквэ+ст
clearstream=клиарстри+м
cleef=клэф
clemente=клэмэ+нтэ
cleopatra=клеопа+тра
cleveland=кли+вланд
clever=клэ+вэр
client=кла+ент
climate=кла+ймат
climb=кла+йм
clinique=клини+к
clio=кли+о
clock=клок
close=кло+уз
clown=кла+ун
club=клаб
cnews=синью+з
co=ко
coal=ко+ул
coarse=корс
cobra=ко+бра
coco=коко+
coconut=ко+конат
cocteau=кокто+
code=код
coding=ко+динг
cofap=ко+фап
coffee=ко+фи
coffeemania=кофема+ния
cold=колд
coldplay=колдплэ+й
colette=коле+т
colgate=ко+лгэйт
collection=коле+кшэн
collective=коле+ктив
college=ко+ледж
collider=кола+йдэр
cologne=коло+н
colonel=кё+нэл
colony=ко+лэни
color=ка+лар
colorado=колора+до
colour=ка+лар
colt=ко+льт
columbia=колу+мбия
columbus=колу+мбус
columnist=ко+ламнист
com=ком
comanche=кома+нч
comb=ко+ум
combat=ко+мбат
combine=комба+йн
combox=комбо+кс
comcast=комка+ст
comcon=комко+н
come=кам
comedy=ко+мэди
comfort=ка+мфорт
command=кома+нд
commander=кома+ндэр
commandement=кома+ндмэнт
comme=ком
comment=ко+мэнт
commerce=ко+мерс
commercial=комё+ршиал
commerzbank=комерцба+нк
commission=коми+шен
committee=коми+ти
commodity=комо+дити
commodore=комодо+р
common=ко+мон
commonwealth=комэнуэ+лс
communicate=камъюникэ+йт
communication=камъюникэ+йшэн
community=комью+нити
commutate=коммутэ+йт
commutated=коммутэ+йтэд
commutation=коммутэ+йшэн
commutator=коммутэ+йтор
comnews=комнью+з
compact=компэ+кт
compal=компэ+л
companionship=компэ+нионшип
company=ка+мпани
compaq=ко+мпак
comparison=компэ+рисон
compete=компи+т
competition=компити+шен
complete=компли+т
completion=компли+шын
complicate=ко+мпликэйт
complication=компликэ+йшын
composite=ко+мпозит
composition=компози+шын
compression=компрэ+шшэн
compromat=компрома+т
comptoir=комптуа+р
compu=ко+мпу
compulenta=компьюле+нта
compulink=компьюли+нк
compulite=компьюла+йт
computer=компью+тэр
computerbase=компьютэрбэ+йс
computerworld=компьютэрво+рлд
computex=компьютэ+кс
computing=компью+тинг
comscore=комско+р
comstock=комсто+к
conakry=ко+накри
concerto=конче+рто
concierge=консье+рж
concise=конса+йз
conclude=конклю+д
concord=конко+рд
conde=кондэ+
condition=канди+шэн
condoleezza=кондоли+за
conference=ко+нференс
confidence=ко+нфидэнс
confident=ко+нфидэнт
confidential=конфидэ+ншыл
config=конфи+г
configuration=конфигурэ+йшэн
confirm=конфё+рм
confirmation=конфирмэ+йшен
confluence=ко+нфлюэнс
confuse=конфью+з
confusion=конфью+жын
congratulate=конгрэ+тъюлэйт
congratulation=конгрэтъюлэ+йшэн
connect=конэ+кт
connecticut=конэ+ктикут
connection=конэ+кшэн
connor=ко+ннор
conqueror=ко+нкэрор
conquest=ко+нквэст
conscience=ко+ншенс
conscious=ко+ншес
consciousness=ко+ншеснэс
conservation=консервэ+йшн
conservative=консё+рватив
consider=конси+дэр
constant=ко+нстант
constantin=константи+н
construction=констра+кшэн
consult=канса+лт
consultancy=конса+лтанси
consulting=канса+лтинг
consumer=консью+мэр
contact=конта+кт
contemporary=контэ+мпорари
contend=контэ+нд
contender=контэ+ндэр
content=контэ+нт
continental=континэ+нтал
continue=конти+нью
continued=конти+ньюд
contour=ко+нтур
contract=ко+нтракт
contrast=ко+нтраст
control=контро+л
convenience=кэнви+ньенс
converge=конвё+рдж
convergys=конвё+рджис
conversation=конверсэ+йшэн
converse=канвё+рс
cooked=кукт
cookery=ку+кэри
cool=кул
coolpix=кулпи+кс
cooper=ку+пер
cooperate=кооперэ+йт
cooperation=кооперэ+йшэн
copenhagen=копенга+ген
copy=ко+пи
copyright=копира+йт
copywriter=копира+йтэр
core=кор
corel=ко+рэл
corian=кориа+н
corner=ко+рнэр
corolla=коро+лла
coronation=коронэ+йшын
corporate=ко+рпорэт
corporated=корпорэ+йтэд
corporation=корпорэ+йшэн
corriere=корье+рэ
corrupt=кора+пт
corsa=ко+рса
corsair=корсэ+р
cosmetic=космэ+тик
cosmopolitan=космопо+литэн
cost=ко+ст
cough=коф
could=куд
council=ка+унсил
countdown=каунтда+ун
counter=ка+унтэр
country=ка+нтри
coupe=купэ+
couple=капл
courage=ка+ридж
courier=курье+р
course=корс
court=корт
courtesy=кё+ртэси
cousin=казн
couture=кутю+р
cover=ка+вэр
coverage=ка+вэрадж
covet=ка+вэт
coward=ка+уэрд
cowardice=ка+уэрдис
crack=крэк
craft=крафт
cranach=кра+нах
crazy=крэ+йзи
create=криэ+йт
creation=криэ+йшн
creative=криэ+йтив
credit=крэ+дит
creditor=крэ+дитор
creme=крэм
cricket=кри+кет
crimea=крайми+а
criminal=кри+минэл
crisis=кра+йсис
critical=кри+тикал
croatia=кроэ+йша
croix=круа+
crossair=кроссэ+ир
crossfire=кросфа+йр
crown=кра+ун
crucial=кру+шел
cruel=кру+эл
cruiser=кру+зэр
cruz=крус
cry=край
crystal=кри+стал
ctrl=ко+нтрол
cubana=куба+на
cultivate=ка+лтивэйт
cultivation=калтивэ+йшын
cultivator=калтивэ+йтэр
culture=ка+лча
cultural=ка+лчерал
cupboard=ка+бэрд
cure=кью+э
cureit=кью+рыт
curiosity=кьюрио+сэти
currency=ка+рэнси
current=ка+ррэнт
curse=кёрс
curtain=кё+ртэн
cushion=ку+шын
custom=ка+стэм
customary=ка+стэмэри
customer=ка+стамэр
cute=кьют
cutie=кью+ти
cuzco=ку+ско
cyber=са+йбэр
cybersecurity=сайберсэкью+рити
cybershot=сайбершо+т
cyprus=са+йпрус
czech=чек
dacia=да+чия
daewoo=дэ+у
daf=даф
dagbladet=дагбла+дэт
dagestan=дагеста+н
daihatsu=дайха+цу
daily=дэ+йли
dailytech=дэйлитэ+к
daimler=да+ймлер
dakar=дака+р
dakota=дако+та
dalai=дала+й
dallas=да+лас
damien=дэ+миен
dancefloor=дэ+нсфлор
dandy=дэ+нди
danger=дэ+нджер
dangerous=дэ+нджерос
daniel=дэ+ниэл
danissimo=дани+ссимо
danone=дано+н
dansk=данск
danube=дану+бэ
dark=дарк
darling=да+рлинг
darudar=даруда+р
dat=дат
data=дэ+йта
database=дэйтабэ+йз
datablog=дэйтабло+г
date=дэйт
daughter=до+тэр
david=дэ+вид
davidoff=давидо+ф
davidson=дэ+видсон
day=дэй
daylight=дэ+йлайт
dax=дакс
daze=дэйз
db=децибе+л
de=дэ
deactivated=диактивэ+йтэд
dead=дэд
deadline=дэдла+йн
deadlock=дэ+длок
deafen=дэфн
dealt=дэлт
death=дэс
debate=дибэ+йт
debt=дэт
debut=дэ+бью
decay=дикэ+й
deceit=диси+т
deceive=диси+в
december=дисэ+мбэр
decision=деси+жен
decisive=диса+йсив
decode=дэко+д
decoder=дэко+дэр
deco=дэко+
decor=дэко+р
decoration=дэкорэ+йшен
decrease=дикри+з
dedicate=дэдикэ+йт
deep=дип
deepwater=дипво+тэр
default=дефо+лт
defeat=дифи+т
defence=дэфэ+нс
defense=дэфэ+нс
defendant=дэфэ+ндант
defiant=дэфа+йант
define=дифа+йн
degree=дэгри+
delaware=дэ+лавэр
delete=дэли+т
delhi=дэ+ли
delicate=дэ+ликит
deliver=дэли+вэр
delivery=дэли+вэри
dell=дэл
della=дэ+лла
delphi=дэ+льфи
delta=дэ+льта
deluxe=дэлю+кс
demand=дема+нд
demo=дэ+мо
democrat=дэ+мокрэт
democratic=дэмокрэ+тик
denied=дина+йд
denoiser=дэно+йзэр
denver=дэ+нвер
deny=дина+й
department=дипа+ртмэнт
depeche=дэпе+ш
depot=депо+
der=дэр
derevo=де+рево
dernier=дэрнье+
des=дэ
descend=дисэ+нд
descent=дисэ+нт
desert=дэ+зырт
design=диза+йн
desigual=дэсигуа+ль
desire=диза+йр
desk=дэск
deskbar=дэ+скбар
desktop=дэскто+п
desmoines=дэмо+йн
desolation=дэзолэ+йшен
despair=дэспэ+ар
despite=диспа+йт
destination=дэстинэ+йшэн
destiny=дэ+стини
destroy=дэстро+й
detail=ди+тэйл
detector=дэтэ+ктор
detektiv=дэтэкти+в
detektive=дэтэ+ктив
determine=дитё+рмин
detox=дито+кс
detroit=дэтро+йт
deus=дэ+ус
deutsch=дойч
deutsche=до+йче
deutschland=до+йчланд
deux=дё
develop=дивэ+лоп
developer=дивэ+лопэр
development=дивэ+лопмэнт
device=дива+йс
devoir=дэвуа+р
dewey=дью+и
d'hotes=дот
diagnostika=диагно+стика
dial=да+йал
dialog=диало+г
dialogue=да+йэлог
diamond=да+ймонд
diary=да+йэри
diaspora=диа+спора
dictation=диктэ+йшен
dictionary=ди+кшэнари
didier=дидье+
dido=да+йда
dies=дайз
diego=дие+го
diepresse=дипрэ+ссэ
diesel=ди+зель
difference=ди+фэрэнс
different=ди+фэрэнт
difficult=ди+фикалт
difficulty=ди+фикалти
digest=да+йджест
digibook=диджибу+к
digital=ди+джитал
digitimes=диджита+ймс
dijon=дижо+н
diligence=ди+лидженс
dimanche=дима+нш
dimension=димэ+ншэн
dinosaur=да+йназор
dion=дио+н
dior=дио+р
direct=дирэ+кт
director=дирэ+ктор
directory=дирэ+ктори
directx=дирэкты+кс
dirol=диро+л
dirty=дё+рти
disable=дизэ+йбл
disagree=дисэгри+
disappear=дисапи+ар
disappearance=дисэпи+рэнс
disappoint=дисапо+йнт
disapprove=дисапру+в
disc=диск
discipline=ди+сиплин
discomfort=диска+мфорт
discontent=дисконтэ+нт
discotheque=дискотэ+к
discount=диска+унт
discover=диска+вэр
discovery=диска+вэри
disease=дизи+з
disk=диск
disney=ди+снэй
display=дисплэ+й
displayport=дисплэйпо+рт
disregard=дисрига+рд
disrespect=дисриспэ+кт
dissatisfaction=диссатисфэ+кшын
dissatisfy=диса+тисфай
distance=ди+станс
distinguish=дисти+нгвиш
distress=дистрэ+с
distribute=дистри+бьют
distribution=дистрибью+шен
distributor=дистрибью+тор
disturb=дистё+рб
divert=дивё+рт
divide=дива+йд
diving=да+йвинг
division=диви+жэн
dixie=ди+кси
dixis=ди+ксис
dnevnik=дневни+к
dni=дни
dniproavia=днипроа+виа
do=ду
doc=док
document=до+кьюмэнт
documentation=документэ+йшэн
dodge=до+дж
dodgeball=доджбо+л
doe=до+у
does=даз
doesn't=дазнт
dolbi=до+лби
dolce=до+льче
dollar=до+ллар
dolls=до+лс
domain=домэ+йн
domini=до+мини
dominicana=доминика+на
domino=домино+
domodedovo=домоде+дово
don't=донт
donbass=донба+с
done=дан
dongfeng=донгфэ+нг
donkey=до+нки
donovan=до+нован
doom=дум
door=дор
doors=до+рс
dorchester=до+рчестэр
dortmund=до+ртмунд
dos=дос
dotted=до+тэд
double=дабл
doubt=да+ут
douglas=ду+глас
dover=до+вэр
dow=до+у
down=да+ун
download=даунло+уд
downloadable=даунло+удабл
downtown=даунта+ун
dozen=дазн
dragon=дрэ+гон
draper=дрэ+йпэр
draw=дро
drawn=дрон
dreamliner=дримла+йнэр
dreamt=дрэмт
drive=драйв
driven=дри+вын
driver=дра+йвер
dropbox=дропбо+кс
drown=дра+ун
drugoi=друго+й
dry=драй
du=дю
dual=дью+ал
dubai=дуба+й
dubawnt=дубо+нт
dublin=ду+блин
dubstep=дабстэ+п
due=дью
duet=дью+эт
dunhill=да+нхил
duo=ду+а
duracell=дюрасэ+л
duran=дюра+н
during=дью+ринг
dushanbe=душанбэ+
dusseldorf=дюссельдо+рф
dutch=дач
duty=дью+ти
dynamic=дайнэ+мик
dynamo=дина+мо
dziennik=дзе+нник
eagle=и+гл
eagles=и+глс
ear=и+ар
earl=э+рл
early=э+рли
earth=э+рс
eastern=и+стэрн
easy=и+зи
easyjet=изидже+т
easylink=изили+нк
easylogo=изило+го
eat=ит
eaten=итн
eatery=и+тэри
eau=о
ebay=ибэ+й
ebook=ибу+к
ecce=э+ккэ
ecco=э+кко
echo=э+хо
eclipse=экли+пс
eco=э+ко
ecoboost=экобу+ст
ecole=эко+ль
economic=иконо+мик
economical=иконо+микал
economically=иконо+микали
economy=ико+номи
ecuador=эквадо+р
eden=и+дэн
edit=э+дит
edition=эди+шэн
editor=э+дитор
edu=эду+
educate=эдьюкэ+йт
education=эдьюкэ+йшэн
educator=эдьюкэ+йтор
eesti=ээ+сти
effect=эфэ+кт
efficiency=эфи+шенси
efficient=эфи+шэнт
ego=э+го
egypt=и+джипт
egyptair=иджиптэ+йр
egyptian=эджи+пшен
eiffel=эфе+ль
eight=эйт
eighteen=эйти+н
eighty=э+йти
eine=а+йнэ
either=а+йзэр
ekaterinburg=екатеринбу+рг
el=эль
elantra=эла+нтра
elastic=ила+стик
elbow=э+лбоу
elderly=э+лдэрли
eldorado=эльдора+до
eleanor=э+леанор
electric=эле+ктрик
electrical=эле+ктрикал
electrician=электри+шын
electricity=электри+сити
electro=эле+ктро
electrolux=электролю+кс
electron=электро+н
electronic=электро+ник
element=э+лэмэнт
elephant=э+лифант
elevation=элевэ+йшен
eleven=илэ+вэн
elibrary=ила+йбэри
elite=эли+т
elizabeth=эли+забэт
elle=эль
else=элс
elsewhere=э+лсвэр
elton=э+лтан
elysees=элизэ+
email=имэ+йл
emanuel=эманюэ+ль
emarket=има+ркет
embassy=э+мбаси
embed=эмбэ+д
emerge=имё+рдж
emergency=имё+рдженси
emirates=э+мирэтс
emma=э+мма
emotion=имо+ушен
emphasis=э+мфасис
empire=эмпа+йр
employment=импло+ймэнт
emporio=эмпо+рио
emulator=эмуля+тор
enable=инэ+йбл
enclose=энкло+уз
encyclopaedia=энсайклопи+диа
encyclopedia=энсайклопи+диа
end=энд
endeavor=эндэ+вор
endeavour=эндэ+вор
ende=э+ндэ
ended=э+ндэд
endure=эндью+р
enemy=э+нэми
energo=энэ+рго
energy=э+нэрджи
enfant=анфа+н
enfants=анфа+н
engagement=энгэ+йджмент
engine=э+нджин
engineer=энджини+р
engineering=энджини+ринг
england=и+нгланд
english=и+нглиш
enhance=энхэ+нс
enhancement=энхэ+нсмэнт
enigma=эни+гма
enjoy=инджо+й
enough=ина+ф
enrique=энри+ки
ensemble=анса+мбль
ent=энтерпра+йзэз
enter=э+нтэр
enterprise=интэрпра+йз
enterpriser=интэрпра+йзэр
enterprisers=интэрпра+йзэрз
entertain=интэртэ+йн
entertainment=интэртэ+йнмэнт
entries=э+нтриз
entry=э+нтри
envie=анви+
environment=энва+йэнмэнт
environmental=энвайэнмэ+нтал
envy=э+нви
epidemic=эпидэ+мик
epidemiology=эпидэмио+лоджи
epoque=эпо+к
epsilon=э+псилон
epson=э+псон
equation=иквэ+йшэн
equinox=эквино+кс
equipment=экуи+пмэнт
equity=э+квити
erevan=ерева+н
erich=э+рих
erickson=э+риксон
ericson=э+риксон
ericsson=э+риксон
erisson=э+рисон
error=э+ррор
esc=эске+йп
escape=эске+йп
escort=эско+рт
eset=эсэ+т
espagnole=эспаньо+ль
espanol=эспаньо+л
especially=испэ+шэли
espoo=э+спо
espresso=эспрэ+ссо
esprit=эспри+
esquire=эсква+йр
essence=э+сэнс
essential=эсэ+ншел
esso=э+ссо
establish=истэ+блиш
established=истэ+блишт
establishment=истэ+блишмент
estate=истэ+йт
estee=э+стэ
estonian=эсто+ниан
ethernet=этырнэ+т
ethical=э+тикал
ethics=э+тикс
eton=и+тон
etro=э+тро
eurasia=евра+зия
euro=е+вро
euroclear=юрокли+ар
eurodance=еврода+нс
eurofighter=еврофа+йтэр
eurofirst=юрофё+рст
euronews=евронью+з
europa=евро+па
europe=ю+роп
european=юропи+эн
europolgaz=европолга+з
eurospeech=евроспи+ч
eurosport=евроспо+рт
eurostar=евроста+р
eurostat=евроста+т
eurovision=юрови+жэн
eve=ив
evelyn=и+влин
even=и+вэн
evening=и+внинг
event=ивэ+нт
ever=э+вэр
everest=эвере+ст
everio=эвэ+рио
everlasting=эвэрла+стинг
evernote=эвэрно+ут
every=э+ври
everybody=э+врибоди
everyday=э+вридэй
everyman=эвримэ+н
everyone=э+вриуан
everything=э+врисынг
evidence=э+видэнс
evil=и+вил
eviterra=эвитэ+рра
evolution=эволю+шэн
evraz=евра+з
ewan=ю+эн
example=икза+мпл
excel=эксэ+л
excelsior=эксэ+льсиор
excellence=э+ксэлэнс
excellent=э+ксэлэнт
except=эксэ+пт
excess=эксэ+с
exchange=иксче+ньдж
exclusive=эксклю+зив
excuse=икскью+с
exe=экзэ+
executive=экзэ+кьютив
exercise=э+ксэрсайз
exhibit=екзи+бит
exhibition=экзиби+шэн
exigen=э+ксиджен
exile=э+кзайл
exist=экзи+ст
exit=э+кзит
exited=икса+йтэд
expect=икспэ+кт
expedia=экспе+дия
expeed=экспи+д
experience=экспи+риенс
experiment=экспе+римент
experimental=экспериме+нтал
expert=э+ксперт
expertise=экспети+з
explay=эксплэ+й
explode=икспло+уд
exploration=эксплорэ+йшен
explore=экспло+р
explorer=экспло+рэр
expo=э+кспо
export=э+кспорт
expose=экспо+уз
exposition=экспози+шэн
express=экспрэ+с
extend=икстэ+нд
extended=икстэ+ндэд
extension=икстэ+ншын
extra=э+кстра
extract=э+кстрэкт
extradition=экстради+шен
extraordinary=экстро+динари
extravip=экстравиайпи+
extreme=экстри+м
eye=ай
eyed=а+йд
eyefinity=айфи+нити
eyewitness=айви+тнэс
faberge=фаберже+
fabia=фа+биа
fable=фэйбл
facebook=фэйсбу+к
fact=фэкт
faction=фэ+кшэн
facto=фа+кто
factor=фэ+ктор
fahrenheit=фаренге+йт
failed=фэйлд
fair=фэйр
faith=фэ+йт
fall=фо+л
famille=фами+ль
family=фэ+мили
famous=фэ+ймас
fantasie=фантази+
fantasy=фэ+нтэзи
far=фар
fargo=фа+рго
farmville=фа+рмвиль
fashion=фэшн
fast=фаст
fatal=фэ+йтал
fatale=фата+ль
father=фа+зэр
fatten=фэ+тэн
faut=фо
favorite=фэ+йварит
faw=фа+у
fax=факс
fcdynamo=эфсидина+мо
fe=фэ+
fear=фи+ар
feather=фэ+зэр
feature=фи+ча
february=фэ+брюари
federation=фэдэрэ+йшен
fedex=федэ+кс
fedpress=федпрэ+с
feed=фид
feel=фил
fellow=фэ+лоу
fellowship=фэ+лоушип
female=фи+мэйл
femme=фам
fendi=фэ+нди
fengshui=фэншу+й
ferdinand=фердина+нд
fergana=фергана+
fergie=фе+рги
fernandez=ферна+ндэс
fernando=ферна+ндо
ferragamo=феррага+мо
ferrari=фира+ри
ferrat=фэрра+
ferre=феррэ+
festival=фе+стивал
fever=фи+вэр
few=фью
ffwd=фастфо+рвард
fiat=фиа+т
fiction=фи+кшен
fidel=фидэ+ль
fidelity=фидэ+лити
field=филд
fierce=фи+эрс
fiesta=фие+ста
fifteen=фифти+н
fifty=фи+фти
figaro=фигаро+
fighters=фа+йтэрс
figure=фи+гэ
file=файл
filippov=фили+пов
film=филм
films=филмз
filter=фи+лтэр
final=фа+йнал
finam=фина+м
finance=фа+йнэнс
financial=файнэ+ншыл
find=файнд
finereader=файнри+дэр
finish=фи+ниш
finland=фи+нлэнд
finlandia=финля+ндия
finmarket=финма+ркет
finnair=финэ+йр
finotec=финотэ+к
firefly=файрфла+й
firefox=фаирфо+кс
firenze=фирэ+нце
firewall=фаерво+л
firewire=файрва+йр
firma=фи+рма
first=фёрст
fischer=фи+шэр
fit=фит
fitness=фи+тнэс
five=файв
flash=флэш
flashback=флэшбэ+к
flat=флэт
flatten=флэ+тэн
flavor=флэ+йвор
flavour=флэ+йвор
fleur=флёр
flickr=фли+кр
floppy=фло+ппи
florence=фло+рэнс
florida=фло+рида
flow=фло+у
flower=фла+уэр
floyd=фло+йд
fluency=флю+энси
fluent=флю+энт
fluxus=флю+ксус
fly=флай
fm=эфэ+м
focus=фо+кус
foie=фуа+
folio=фо+лио
follow=фо+лоу
following=фо+лоуинг
fondazione=фондацио+нэ
fontanka=фонта+нка
foo=фу+
football=фу+тбол
for=фор
forbes=фо+рбз
forbid=форби+д
forbidden=форби+дэн
force=форс
ford=форд
foreground=фо+рграунд
foreign=фо+рин
foreigner=фо+ринэр
forester=фо+рэстэр
forex=фо+рэкс
forexpf=форэкспиэ+ф
forget=форгэ+т
forgiven=форги+вэн
format=фо+рмат
formula=фо+рмула
forrester=фо+рэстэр
forticom=фортико+м
fortnum=фо+ртнум
fortuna=форту+на
fortunate=фо+рчунит
fortune=фо+рчун
forty=фо+рти
forum=фо+рум
forward=фо+рвард
foto=фо+то
fotobank=фотоба+нк
foton=фото+н
fought=фот
found=фаунд
foundation=фаундэ+йшэн
four=фор
foursquare=форсквэ+р
fourteen=форти+н
fourth=форс
fox=фокс
foxconn=фокско+н
foxmarket=фоксма+ркет
foxnews=фокснью+с
fracture=фрэ+кча
fragrance=фрэ+йгранс
fraiche=фрэш
frame=фрэйм
framework=фрэ+ймворк
francais=франсэ+
france=фра+нс
francisco=франци+ско
francois=франсуа+
francoise=франсуа+з
frankfort=фра+нкфорт
frankfurt=фра+нкфурт
frankfurter=фра+нкфуртэр
frankreich=фра+нкрайх
franz=фра+нц
fratria=фра+трия
frederic=фредери+к
free=фри
freedrweb=фридокторвэ+б
freelander=фрилэ+ндэр
freemarket=фрима+ркет
freetrack=фритрэ+к
freeware=фривэ+ар
freightliner=фрэйтла+йнэр
french=фрэнч
frequency=фри+квэнси
freud=фрэйд
friday=фра+йди
friend=фрэнд
friendly=фрэ+ндли
friendship=фрэ+ндшип
fright=фрайт
from=фром
front=франт
frontier=фронти+р
frugurt=фру+гурт
fruit=фрут
fruttis=фру+тис
fry=фрай
fuck=фак
fucked=факт
fuel=фью+эл
fuji=фу+джи
fujifilm=фуджифи+лм
fujitsu=фуджи+тсу
full=фул
fully=фу+ли
fun=фан
function=фа+нкшен
functional=фа+нкшенал
functionally=фа+нкшенали
funeral=фью+нерал
funk=фанк
furniture=фё+рничер
furtado=фурта+до
further=фё+рзэр
fusion=фью+жэн
fuso=фу+со
future=фью+че
gabbana=габа+на
gabon=габо+н
gadget=га+джет
gaiety=гэ+ити
gala=гала+
galactic=гала+ктик
galant=гала+нт
galaxy=гэ+лэкси
galerie=галери+
galery=гэ+лери
galileo=галиле+о
gallagher=гэ+лахир
gallery=гэ+лери
galliano=галья+но
gallon=гэ+лон
galloper=гало+пэр
gallup=гэ+ллап
galoises=галуа+з
game=гейм
gameboy=геймбо+й
gamer=гэ+ймэр
garage=гара+ж
garbage=га+рбидж
garcon=гарсо+н
garden=га+рдэн
garnier=гарнье+
gates=гейтс
gateway=гэ+йтвэй
gather=гэ+зэр
gatwick=га+твик
gauche=гош
gaudeamus=гаудэа+мус
gauguin=гоге+н
gaultier=готье+
gaz=газ
gazeta=газе+та
gazprombank=газпромба+нк
gear=гир
gecko=гэ+ко
geek=гик
geely=джи+ли
geforce=джифо+рс
gelandewagen=геландэва+гэн
gem=джем
gemini=дже+мини
gene=джин
general=дже+нерал
generale=женера+ль
generation=дженерэ+йшэн
genesis=джэ+нэсис
genesys=джэ+нэсис
geneva=джэни+ва
geneve=женэ+в
genius=джи+ньэс
genome=джи+ном
genosse=гено+ссэ
gentleman=джэ+нтлмэн
genuine=дже+ньюин
geo=ге+о
geocentre=геосэ+нтэр
geographic=джеогра+фик
geology=джио+лоджи
geophysical=джиофи+зикал
georg=гео+рг
george=джордж
georgetown=джорджта+ун
georgia=джо+рджиа
georgian=джо+рджиан
geoscience=геоса+йэнс
gergiev=ге+ргиев
german=джо+рман
germania=герма+ния
germanwings=джорманви+нгз
germany=джо+рмани
gertz=герц
gesellschaft=гэзэ+льшафт
get=гэт
getty=ге+тти
gettyimages=геттии+маджэз
getz=ге+тс
ghost=го+уст
ghostnet=гостнэ+т
giambattista=джамбати+ста
gianfranco=джанфра+нко
giant=джа+йант
gibson=ги+бсон
gif=гиф
giga=ги+га
gigabit=гигаби+т
gigabyte=гигаба+йт
gillette=джилэ+т
gimp=гимп
giorgio=джо+рджо
giotto=джо+тто
girl=гёл
girlfriend=гё+лфрэнд
gismeteo=гисме+тео
giulia=джу+лия
give=гив
given=ги+вэн
givenchy=живанши+
glamour=гламу+р
global=гло+бал
globe=глоб
gloria=гло+рия
gmail=джимэ+йл
gmarket=джима+ркет
go=го+у
goalkeeper=гоулки+пэр
goat=го+ут
godzilla=годзи+лла
goes=го+уз
gold=голд
golden=го+лдэн
goldman=го+лдман
goldstone=голдсто+ун
golf=го+льф
goltsblat=го+лтсблат
gone=гон
good=гуд
goodbye=гудба+й
google=гу+гл
googledocs=гуглдо+кс
googletalk=гуглто+к
gorillaz=гари+лаз
goroskop=гороско+п
gosh=го+ш
gosuslugi=госуслу+ги
goto=гоуту+
gourmet=гурмэ+
goutal=гута+ль
gouverneur=гувернё+р
government=га+вэрмэнт
gprs=джипиэрэ+с
grade=грэйд
gradual=грэ+дьюэл
graduate=грэ+дьюэйт
graff=граф
grammar=грэ+ммар
grammatical=грама+тикал
grammophone=грамофо+н
grand=грэнд
grandis=гра+ндис
grange=гранж
granma=гра+нма
granta=гра+нта
graph=гра+ф
graphics=гра+фикс
gras=гра
grass=грас
grateful=грэ+йтфул
gray=грэ+й
gravity=гра+вити
great=грэйт
greatest=грэ+йтэст
green=грин
greenhouse=гри+нхаус
greenpeace=гринпи+с
greeting=гри+тинг
grinderman=грайндэрмэ+н
grisogono=грисого+но
gropius=гро+пиус
ground=гра+унд
group=груп
groupon=групо+н
grow=гро+у
grown=гро+ун
grozny=гро+зный
grupo=гру+по
gsmart=джисма+рт
gtalk=джито+к
guangzhou=гуанчжо+у
guard=гард
guardia=га+рдиа
guardian=га+рдиан
guatemala=гватэма+ла
gucci=гу+ччи
guerilla=гери+лья
guerlain=герле+н
guess=гэс
guest=гэст
guide=гайд
guideline=га+йдлайн
guilt=гилт
guilty=ги+лти
guinness=ги+ныс
guitar=гита+р
gulag=гула+г
gun=ган
guns=га+нс
guns'n'roses=ганзынро+узыз
guy=гай
gwen=гвэ+н
gym=джи+м
habanera=хабанэ+ра
habilis=ха+билис
hacker=ха+кер
hadley=хэ+дли
hafei=хафэ+й
hague=хэйг
haima=ха+йма
hainan=хайна+н
hallelujah=халэлу+йя
half=хаф
hall=хол
hallo=хэло+
halt=холт
hamas=хама+с
hamburg=га+мбург
hamburger=га+мбургер
hammer=ха+мэр
hampshire=хэ+мпшир
hand=хэнд
handelsblatt=хандэльсбла+т
handicap=хэ+ндикап
handkerchief=хэ+нкэрчиф
handout=хэнда+ут
handshake=хэ+ндшейк
handwriting=хэ+ндрайтинг
hangout=хэнга+ут
hangover=хэнго+вэр
hannover=гано+вер
hanoi=хано+й
hanover=гано+вер
hansen=ха+нсэн
happen=хэ+пэн
happiness=хэ+пинэс
happy=хэ+ппи
harare=хара+ре
hard=хард
hardcore=хардко+р
hardware=хардвэ+р
harley=ха+рли
harmony=ха+рмони
harrier=ха+рриэр
harrisburg=ха+рисбург
harry=ха+ри
hartford=ха+ртфорд
hasta=а+ста
hasten=хэ+йсэн
hauptbahnhof=хауптба+нхоф
haus=ха+ус
haute=от
have=хэв
haven't=хэ+вынт
hawaii=гава+и
hazard=хэ+зард
he=хи
head=хэд
headache=хэ+дэйк
headhunter=хэдха+нтыр
headphone=хэдфо+ун
headquarters=хэдкво+тэрс
headword=хэ+дворд
health=хэлс
healthy=хэ+лси
hear=хи+эр
heard=хёрд
heart=харт
heartbreak=ха+ртбрэйк
heathrow=хи+троу
heaven=хэ+вэн
heavenly=хэ+вэнли
heavy=хэ+ви
hebei=хэбэ+й
height=хайт
heighten=ха+йтэн
heineken=ха+йнекен
heir=эйр
heist=хайст
held=хэлд
helena=хэле+на
helicopter=хэлико+птэр
hellfire=хэлфа+йр
hello=хэло+
help=хэлп
helsinki=хе+льсинки
helvetica=гельве+тика
hennessy=хэ+нэси
her=хёр
herald=хэ+ралд
hercule=эркю+ль
here=хи+эр
heritage=хэ+ритэдж
hermes=эрмэ+с
hermitage=хэ+рмитадж
hero=хи+ро
heroes=хи+роус
herrera=эрэ+ра
hertz=герц
hesitate=хэ+зитэйт
hesitation=хэзитэ+йшын
heuer=хо+йэр
hewlett=хью+лет
hezbollah=хезбола+
hi=хай
hibiscus=гиби+скус
hide=хайд
high=хай
highland=ха+йлэнд
highlander=ха+йлэндэр
highlight=хайла+йт
highscreen=хайскри+н
hightech=хайтэ+к
hilfiger=хи+льфигер
hindustan=хиндуста+н
hino=хи+но
his=хиз
hispano=испа+но
histoire=истуа+р
historic=хисто+рик
history=хи+стори
hitachi=хита+чи
hitech=хайтэ+к
hoff=хо+ф
hold=хо+лд
holding=хо+лдинг
holiday=хо+лидэй
holiness=хо+линэс
holliday=хо+лидэй
hollow=хо+лоу
hollywood=хо+ливуд
holmes=холмс
holstein=хо+льстэн
home=хо+ум
homecoming=хо+умкаминг
homepage=хоумпэ+йдж
homestay=хоумстэ+й
homework=хо+умворк
homezone=хоумзо+н
hommage=ома+ж
homme=ом
homo=хо+мо
honda=хо+нда
honesty=о+нэсти
honest=о+нэст
honey=ха+ни
honeycomb=ханико+м
hongkong=гонко+нг
hongqi=хунци+
honiara=хониа+ра
honolulu=гонолу+лу
honour=о+нор
honourable=о+норабл
hope=хо+уп
horizon=хора+йзн
horizontal=хоризо+нтал
hospital=хо+спитал
hosting=хо+стинг
hot=хот
hotbox=хотбо+кс
hotel=хатэ+л
hotmail=хотмэ+йл
hotspot=хотспо+т
houdini=гуди+ни
hour=а+уэр
house=ха+ус
housekeeping=хауски+пинг
houses=ха+узиз
housing=ха+узинг
houston=хью+стон
how=ха+у
hoya=хо+йя
html=эйчтиэмэ+л
huawei=хуавэ+й
hubble=хабл
huffington=ха+фингтон
hugo=хью+го
human=хью+мэн
humanities=хьюма+нитиз
humax=хью+макс
humberto=умбэ+рто
humiliate=хьюми+лиэйт
humor=хью+мор
humour=хью+мор
hundred=ха+ндрэд
hungarian=хангэ+риан
hungary=ха+нгэри
hunger=ха+нгэр
hybrid=ха+йбрид
hydra=ги+дра
hydro=ги+дро
hyper=ха+йпер
hyperlink=гиперли+нк
hysterical=хистэ+рикал
hyundai=хюнда+й
i=ай
i'll=айл
i'm=айм
i've=айв
ibook=айбу+к
ibookstore=айбу+кстор
iceberg=а+йсберг
ich=их
icloud=айкла+уд
icon=а+йкон
iconic=айко+ник
idaho=айда+хо
idea=айди+а
ideapad=айдиапэ+д
identification=айдэнтифике+йшн
identifier=айдэнтифа+ер
identity=айдэ+нтити
idiot=и+диот
idle=айдл
idol=а+йдол
if=иф
iglesias=иглэ+сиас
iglobe=айгло+б
ignore=игно+р
igoogle=айгу+гл
ikea=ике+а
illegal=или+гал
illinois=илино+йс
illuminate=илюминэ+йт
illumination=илюминэ+йшен
illustrate=илюстрэ+йт
illustration=илюстрэ+йшен
illustrator=илюстрэ+йтор
image=и+мадж
images=и+маджес
imaginary=имэ+джинари
imaginative=имэ+джинатив
imagine=имэ+жин
imaging=и+миджинг
imax=айма+кс
imessage=аймэ+сэдж
imhonet=имхонэ+т
imitate=и+митэйт
imitation=имитэ+йшын
immense=имэ+нс
imoney=айма+ни
imovie=айму+ви
implication=импликэ+йшен
important=импо+ртант
improve=импру+в
in=ин
inbox=инбо+кс
inc=инк
incanto=инка+нто
inch=и+нч
include=инклю+д
inclusive=инклю+сив
incom=инко+м
income=и+нкам
incorrect=инкорэ+кт
increase=инкри+з
independence=индэпэ+ндэнс
independent=индэпэ+ндэнт
indesit=индэзи+т
index=и+ндэкс
indexing=и+ндэксинг
india=и+ндия
indiana=индиа+на
indianapolis=индиана+полис
indicator=индикэ+йтор
inditex=индитэ+кс
indonesia=индонэ+зия
indoor=индо+р
industrial=инда+стриал
industry=и+ндастри
inferno=инфэ+рно
infineon=инфи+неон
infinite=и+нфинит
infiniti=инфи+нити
infinity=инфи+нити
infium=и+нфиум
influence=и+нфлюэнс
influential=инфлюэ+ншыл
influenza=инфлюэ+нца
info=и+нфо
infomost=инфомо+ст
inform=инфо+рм
information=информэ+йшэн
infox=инфо+кс
infra=и+нфра
infracom=инфрако+м
infrared=инфрарэ+д
infrastructure=инфрастра+кче
inglenook=инглну+к
initiative=ини+шиатив
ink=инк
innocent=и+носэнт
innodisk=инноди+ск
innovanews=иннованью+з
innovate=и+нновэйт
innovation=инновэ+йшен
innovative=инновэ+йтив
inopressa=инопрэ+сса
inosmi=иносми+
input=и+нпут
inquire=инква+йр
inquiry=инква+йэри
ins=инсё+рт
insert=инсё+рт
inshare=инше+р
inside=инса+йд
insight=и+нсайт
inspiration=инспирэ+йшэн
instagram=инстагра+м
install=инсто+л
installation=инсталэ+йшен
instant=и+нстант
institute=и+нститьют
institution=инститью+шен
institutional=инститью+шенал
instruction=инстра+кшэн
instrument=и+нструмент
insure=иншу+эр
intel=и+нтэл
intellect=и+нтэлэкт
intellectual=интэлэ+кчуал
intelligence=интэ+лиджинс
intelligent=интэ+лиджинт
intelteh=интэлте+х
inteltech=интэлте+х
inter=и+нтэр
interaction=интэра+кшэн
interactive=интэра+ктив
interbank=интэрба+нк
intercom=интэрко+м
intercontinental=интэрконтине+нтал
interest=и+нтэрэст
interface=интэрфэ+йс
interfax=интэрфа+кс
interfere=интэрфи+эр
interference=интэрфи+рэнс
international=интэрнэ+шэнэл
internazionale=интэрнацьона+лэ
internet=интэрнэ+т
interrupt=интэра+пт
interruption=интэра+пшэн
interview=и+нтэрвью
interviewer=интэрвью+эр
interviewing=интэрвью+инг
intervox=интэрво+кс
inthecity=инзэси+ти
into=и+нту
intonation=интонэ+йшен
intranet=интранэ+т
introduction=интрада+кшэн
invalid=и+нвалид
invent=инвэ+нт
invest=инвэ+ст
investfunds=инвестфа+ндз
investigate=инвэ+стигэйт
investigation=инвэстигэ+йшен
investment=инвэ+стмэнт
investor=инвэ+стор
involve=инво+лв
inward=и+нворд
ion=ио+н
iowa=айо+ва
ipad=айпэ+д
iphone=айфо+н
iphoto=айфо+то
iplayer=айплэ+ер
ipod=айпо+д
iran=ира+н
iranair=иранэ+йр
iranian=ира+ниан
iraq=ира+к
ireland=а+йрлэнд
irish=а+йриш
irk=ирк
irkutsk=ирку+тск
iron=а+йан
is=из
islam=исла+м
islamist=и+сламист
island=а+йлэнд
isle=айл
israel=изра+иль
israir=изрэ+йр
issey=исэ+й
issue=и+сью
isuzu=ису+зу
it=ит
italia=ита+лия
italiana=италья+на
italiano=италья+но
italic=ита+лик
italy=и+тали
itmonitoring=айтимонито+ринг
itnews=айтинью+з
itunes=айтю+нс
ivan=ива+н
iveco=иве+ко
ivy=а+йви
izvestia=изве+стия
jabber=джа+бер
jabra=джа+бра
jac=джак
jackson=джэ+ксон
jacksonville=джэ+ксонвил
jacobs=я+кобс
jaguar=ягуа+р
jaiku=джа+йку
jailbreak=джейлбрэ+йк
jam=джэ+м
jamais=жамэ+
james=джеймс
jameson=дже+ймсон
jane=джэйн
janet=джэ+нит
january=джэ+ньюари
japan=джапэ+н
jardin=жардэ+н
jason=дже+йсон
jat=джат
java=джа+ва
javascript=джаваскри+пт
javier=хавье+р
jaw=джо
jazeera=джази+ра
jazz=джа+з
je=же
jealous=джэ+лэс
jealousy=джэ+лэси
jean=жан
jeans=джинз
jeep=джип
jeeves=дживс
jefferson=джэ+ферсон
jeffrey=дже+фри
jennifer=джэ+нифэр
jeremy=дже+реми
jerome=джеро+м
jersey=джэ+рси
jesus=джи+зас
jet=джэт
jetta=джэ+та
jetway=джетвэ+й
jetzt=йетц
jewel=джу+эл
jeweller=джу+элэр
jewellery=джу+элри
jewelry=джу+элри
jinbei=джинбэ+й
jingle=джингл
job=джоб
joe=джо
john=джон
johnny=джо+ни
johnson=джо+нсон
join=джо+йн
jonathan=джо+натан
jones=джо+нс
jong=йонг
jose=хосэ+
josef=джо+зэф
joseph=джо+зэф
josephine=джо+зэфин
joshua=джо+шуа
jour=жур
journal=джо+рнал
journalism=джо+рнализм
journalist=джо+рналист
journey=джо+рни
jovi=джо+ви
joy=джо+й
jpeg=джейпе+г
jpg=джипе+г
jpmorgan=джейпимо+рган
j'son=дже+йсон
juan=хуа+н
judge=джадж
juice=джус
jules=жюль
julian=джу+лиан
julianne=джу+лиан
juliet=джу+лиет
julio=ху+лио
july=джула+й
june=джун
juneau=джу+но
juniper=джу+нипэр
junkie=джа+нки
just=джаст
justice=джа+стис
justin=джа+стин
ka=ка+
kabul=кабу+л
kaleva=ка+лева
kalina=кали+на
kaliningrad=калинингра+д
kaliningradskaya=калинингра+дская
kaluga=калу+га
kangoo=кангу+
kansas=канза+с
karaoke=карао+ке
karelia=каре+лия
kasparov=каспа+ров
kaspersky=каспе+рский
katalog=катало+г
kate=кейт
katherine=кэ+трин
kavkaz=кавка+з
kavkazcenter=кавказце+нтр
kazakstan=казахста+н
kazan=каза+нь
keen=кин
kefir=кефи+р
keith=кит
kelis=кэ+лис
kenga=ке+нга
kennedy=ке+нэди
kenneth=кэ+нэт
kent=кент
kentucky=кента+ки
kenworth=кэ+нворт
kenya=ке+ния
kenzo=кензо+
kerch=керчь
key=ки
keyboard=ки+борд
kharkov=ха+рьков
kia=ки+а
kiasma=киа+сма
kid=кид
kiev=ки+ев
kill=кил
killed=килд
killers=ки+лирс
kind=ка+инд
kingdom=ки+ндом
kinoafisha=киноафи+ша
kinopoisk=кинопо+иск
kinozal=киноза+л
kirche=ки+рхе
kirill=кири+л
kitten=ки+тэн
klein=кляйн
kleine=кля+йнэ
klm=каэлэ+м
knife=найф
knigi=кни+ги
know=но+у
knowledge=но+лидж
knowles=но+улс
known=но+ун
kodak=ко+дак
kolavia=кола+виа
komatsu=кома+цу
kombat=ко+мбат
kommersant=коммерса+нт
konica=ко+ника
korea=коре+я
korean=кори+ан
korn=ко+рн
koryo=кори+о
kraftwerk=кра+фтверк
krakow=кра+ков
krasnodar=краснода+р
krause=кра+узэ
kravitz=кра+витс
kredit=креди+т
kremlin=крэ+млин
kremlinrussia=крэмлинра+ша
kroogi=круги+
kulichki=кули+чки
kultur=культу+р
kunst=кунст
kunsthalle=кунстха+ле
kunsthaus=кунстха+ус
kuntsevo=ку+нцево
l'abbe=ляббэ+
la=ла
lab=лэб
label=лэ+йбл
labor=лэ+йбор
laboratory=лабо+ратори
labour=лэ+йбор
lacetti=лаче+ти
lachaise=лаше+з
lacoste=лако+ст
lacroix=лакруа+
lada=лада
ladbrokes=лэ+дброкс
ladies=лэ+йдиз
lady=лэ+ди
lafleur=лафлё+р
laguna=лагу+на
laid=лэйд
lake=лэйк
lalique=лали+к
lamborghini=ламбарги+ни
lancaster=ланка+стэр
lancer=ла+нсер
lancia=ля+нча
lancome=ланко+м
land=лэ+нд
landcruiser=лэндкру+зэр
language=лэ+нгвидж
lansing=ла+нсинг
lanvin=ланвэ+н
lap=лэп
lardi=ла+рди
large=лардж
larisa=лари+са
larnaca=ларна+ка
las=лас
laser=ла+зер
last=ласт
laszlo=ла+сло
late=лэ+йт
lately=лэ+йтли
latin=лэ+тин
latitude=лэ+титьюд
lauder=ла+удыр
laugh=лаф
laughter=ла+фтэр
launchpad=лончпэ+д
launder=ло+ндэр
laurent=лора+н
lavazza=лава+цца
lavigne=лави+н
law=ло
lawrence=ло+рэнс
lawrie=ло+ри
lawyer=ло+ер
lay=лэй
lazy=лэ+йзи
le=лэ
lead=лид
leader=ли+дэр
leading=ли+динг
learn=лёрн
learnt=лёрнт
least=лист
leather=лэ+зэр
leave=лив
lebanon=ле+банон
leboeuf=лебо+ф
led=лэ+д
left=лэфт
legacy=лэ+гаси
legal=ли+гал
legend=лэ+дженд
legendary=лэ+джендари
lego=ле+го
lehman=лэ+ман
leica=ле+йка
leipzig=ле+йпциг
leisure=лэ+же
lend=лэнд
lenny=ле+ни
lenoblast=лено+бласть
lenta=ле+нта
leon=лео+н
leonard=леона+рд
leonardo=леона+рдо
leopard=ле+пард
leopold=леопо+льд
lesbian=лэ+сбиан
let=лэт
letter=лэ+тэр
level=лэ+вэл
levin=ле+вин
lexicon=лэ+ксикон
lexus=ле+ксус
liability=лайаби+лити
liam=ли+ам
liar=ла+йэр
liaz=лиа+з
liberal=ли+берал
liberation=либерэ+йшен
libertine=ли+бэртин
liberty=ли+бэрти
librarian=лайбрэ+риан
library=ла+йбрэри
libreville=либрэви+ль
license=ла+йсэнс
lie=лай
lifan=лифа+н
life=лайф
lifeline=ла+йфлайн
lifenews=лайфнью+з
lifestyle=лайфста+йл
lifetime=ла+йфтайм
light=лайт
lighthouse=ла+йтхаус
ligne=линь
lilongwe=лило+нгвэ
limit=ли+мит
limited=ли+митэд
limiting=ли+митинг
limo=ли+мо
limonex=лимонэ+кс
limousine=лимузи+н
limp=ли+мп
lincoln=ли+нкольн
line=лайн
linear=ли+нэар
linguistic=лингви+стик
lingvo=ли+нгво
link=линк
linkin=ли+нкин
linux=ли+нукс
lion=ла+йон
lipstick=ли+пстик
list=лист
listen=лисн
lite=лайт
literary=ли+трэри
literature=ли+трэче
lithuania=лисуэ+ниа
little=литл
live=лайв
livebook=лайвбу+к
livecity=лайвси+ти
livedemo=лайвдэ+мо
liveinternet=лайвынтэрнэ+т
livejournal=лайвджо+рнал
liverpool=ливерпу+ль
lives=ливз
livesport=лайвспо+рт
living=ли+винг
livingston=ли+вингстон
lloyd=лойд
load=ло+уд
loading=ло+удинг
loaf=ло+уф
local=ло+кал
locally=ло+кали
location=локэ+йшэн
lock=лок
lockerbie=локэрби
lockheed=ло+кхид
lodge=лодж
log=лог
logan=ло+ган
logger=ло+ггер
login=логи+н
logitech=лоджитэ+к
logo=ло+го
london=ла+ндын
lonely=ло+нли
longines=лонжи+н
look=лук
lookatme=лукэтми+
loop=луп
lopez=ло+пэс
loquendo=локвэ+ндо
l'oreal=лореа+ль
lordi=ло+рди
los=лос
lose=луз
lost=лост
lottery=ло+тыри
lotus=ло+тус
louboutin=лубутэ+н
louis=луи+
louisiana=луизиа+на
louisville=лу+исвил
lounge=ла+ундж
louvre=лувр
love=лав
lovely=ла+вли
loveplanet=лавплэ+нет
low=ло+у
lowenbrau=лёвенбро+й
loyalty=ло+йэлти
ltd=элтэдэ+
luanda=луа+нда
lubernet=любернэ+т
lucent=лю+сэнт
lucia=лючи+я
lucky=ла+ки
lucy=лю+си
ludwig=лю+двиг
lufthansa=люфтга+нза
luis=луи+с
lukoil=луко+йл
lumenvox=люмэнво+кс
lumia=лю+мия
lumiere=люмье+р
lumix=лю+микс
lux=люкс
luxe=люкс
luxembourg=люксембу+рг
luxury=ла+кшери
lynnfield=ли+нфилд
lyrix=ли+рикс
lytdybr=лытды+бр
ma=ма
macbook=макбу+к
machaon=махао+н
machine=маши+н
macintosh=макинто+ш
macro=ма+кро
macroeconomic=макроэконо+мик
macroeconomics=макроэконо+микс
macromedia=макроме+диа
macy=мэ+йси
mad=мэд
madam=мэ+дэм
madame=мада+м
madden=мэ+дэн
made=мэйд
mademoiselle=мадмуазэ+ль
madison=мэ+дисон
madoff=мэ+доф
madonna=мадо+на
madre=ма+дрэ
madrid=мадри+д
maestro=маэ+стро
mafia=ма+фия
magazine=мэ+гэзин
magic=мэ+джик
magical=мэ+джикал
magna=ма+гна
magnum=ма+гнум
magnus=ма+гнус
magyar=мадья+р
mahal=маха+л
maharaja=махара+джа
mahindra=махи+ндра
maiden=мэ+йдэн
mail=мэйл
mailto=мэйлту+
main=мэйн
maine=мэн
mainstream=мэйнстри+м
maison=мэзо+н
majesty=мэ+джести
majority=маджо+рити
make=мэйк
maker=мэ+йкэр
makhachkala=махачкала+
makro=ма+кро
malahit=малахи+т
malaysia=малэ+йжа
male=мэйл
malev=ма+лев
mall=мол
malle=маль
malta=ма+льта
malware=малвэ+ар
maman=мама+н
mamba=ма+мба
mamma=ма+ма
man=мэн
manage=мэ+нэдж
management=мэ+нэджмэнт
manager=мэ+нэджэр
managua=мана+гуа
manchester=манче+стэр
mandalay=мандалэ+й
mandarin=мэ+ндарин
mandate=мэ+ндэйт
mandated=мэндэ+йтэд
mandatory=мэ+ндэтри
mange=манж
mango=ма+нго
manhattan=манхэ+ттэн
mania=ма+ниа
manic=мэ+ник
mankind=мэ+нкайнд
manu=ма+ну
manual=мэ+нюал
manuel=мануэ+ль
manufacturing=мэнюфэ+кчеринг
map=мэп
maple=мэйпл
mapping=мэ+пинг
marc=ма+рк
marcel=марсэ+ль
march=марч
marche=марш
margaret=ма+ргарэт
marginem=ма+ргиным
maria=мари+я
marie=мари+
mariinsky=марии+нский
marilyn=мэ+рилин
marine=мари+н
mario=ма+рио
mariupol=мариу+поль
mariya=мари+я
market=ма+ркет
marketing=ма+ркетинг
marketplace=маркетплэ+йс
marketwatch=маркетво+ч
marlboro=ма+льборо
marmite=ма+рмайт
maroc=маро+к
maroon=мару+н
maroon5=марунфа+йв
marque=марк
marrу=мэ+ри
married=мэ+рид
marriott=мэ+риот
mars=марс
marta=ма+рта
martell=мартэ+л
martin=ма+ртин
martini=марти+ни
maruti=мару+ти
marvelous=ма+рвэлос
mary=мэ+ри
maryland=мэ+рилэнд
mascarpone=маскарпо+нэ
mascotte=маско+т
maserati=мазэра+ти
maseru=ма+серу
masha=ма+ша
mashable=мэ+шабл
mason=мэ+йсон
masqat=маска+т
massachusetts=масачу+сетс
massimo=ма+ссимо
massive=мэ+сив
master=ма+стер
mastercard=мастерка+рд
masterpad=мастерпэ+д
matador=матадо+р
material=мати+риэл
matisse=мати+сс
matiz=мати+з
mattel=матэ+л
matter=мэ+тэр
mauritania=маврита+ниа
mauvais=мовэ+
max=макс
maxi=ма+кси
maxim=макси+м
maxima=ма+ксима
maximum=ма+ксимум
maximus=ма+ксимус
may=мэй
maybach=ма+йбах
mazda=ма+зда
mcafee=мака+фи
mcarthur=мака+ртур
mckenzie=макке+нзи
mcdonald=макдо+нальд
mcdonald's=макдо+нальдс
mcduck=макда+к
mclaren=макла+рэн
mcmoran=макмо+ран
mcqueen=маккви+н
mean=мин
meant=мэнт
meantime=ми+нтайм
meanwhile=ми+нвайл
measure=мэ+жэ
mechanic=мекэ+ник
media=ме+диа
mediaclub=медиаклу+б
medialab=медиала+б
medialand=медиалэ+нд
mediamarkt=медиама+ркт
medianews=медианью+з
mediawiki=медиави+ки
medical=мэ+дикал
medicare=мэдикэ+р
medici=ме+дичи
medicine=мэ+дисин
mediterranean=медитэрэ+йниан
medium=ме+диум
medvedev=медве+дев
meeting=ми+тинг
mega=ме+га
megacom=мегако+м
megafon=мегафо+н
megafonnw=мегафонэнда+блйу
megafonpro=мегафонпро+
megamind=мегама+йнд
megane=мига+н
megaplex=мегапле+кс
megapro=мегапро+
megavip=мегавиайпи+
meindl=майндл
melody=мэ+лоди
membrana=мембра+на
memo=мэ+мо
memoir=мэ+муар
memoire=мэмуа+р
memories=мэ+мориз
memory=мэ+мори
memphis=мэ+мфис
menatep=менатэ+п
mentos=мэ+нтос
menu=меню+
mercantile=мё+ркантайл
mercedes=мерседэ+с
merchant=мё+рчант
mercury=мэ+ркьюри
mercy=мё+рси
mere=ми+эр
meridien=меридиа+н
merrill=мэ+рил
merry=мэ+ри
mesdames=меда+м
mesmerise=мэ+смэрайз
message=мэ+сэдж
messe=ме+ссы
messenger=мэ+сэнджэр
messiah=меса+йа
meta=ме+та
metal=ме+тал
metallica=мета+лика
metallurgica=металу+ргика
metaltorg=металто+рг
metamorphosis=метаморфо+зис
meteo=ме+тео
meteonova=метеоно+ва
meter=ми+тэр
method=мэ+тод
metro=ме+тро
metromap=метромэ+п
metropole=метропо+ль
metropolitan=метропо+литэн
metropolitain=метрополитэ+н
mexicano=мексика+но
mexico=ме+хико
mforum=эмфо+рум
mia=ми+а
miami=майа+ми
miat=миа+т
michael=майкл
michel=мише+ль
michele=мише+ль
michelin=мишле+н
michigan=ми+чиган
micron=микро+н
microphone=ма+йкрофон
microsite=майкроса+йт
microsoft=майкросо+фт
microsystems=майкроси+стэмз
midi=ми+ди
migrant=ма+йгрант
mikimoto=микимо+то
milagro=мила+гро
milan=мила+н
mild=майлд
military=ми+литэри
milky=ми+лки
millennium=миле+ниум
miller=ми+ллер
millhouse=ми+лхаус
million=ми+лион
millionaire=ми+лионэр
millionnaire=ми+лионэр
milwaukee=милуо+ки
min=мин
minbank=минба+нк
mind=майнд
mine=майн
mineral=ми+нэрал
mini=ми+ни
minimise=минима+йз
minimize=минима+йз
minimum=ми+нимум
minister=ми+нистэр
ministry=ми+нистри
minneapolis=миниа+полис
minnesota=минисо+та
minority=майно+рити
minus=ма+йнэс
minute=ми+нэт
miracle=ми+ракл
mirage=мира+ж
miramax=мирама+кс
miranda=мира+нда
mirax=ми+ракс
mirkino=миркино+
mirror=ми+рор
miscellaneous=мисэлэ+ниас
miserable=ми+зэрэбл
misery=ми+зэри
mississippi=мисиси+пи
missouri=мису+ри
mister=ми+стер
mitino=ми+тино
mitsubishi=мицуби+си
mittal=ми+ттал
miu=ми+у
miuccia=миу+ча
mixed=микст
mixture=ми+ксче
miyake=мия+ке
mkad=мкад
mobiguru=мобигу+ру
mobil=моби+л
mobile=моба+йл
mode=мо+д
modem=модэ+м
moderate=модэрэ+йт
moderation=модэрэ+йшын
moderator=модэра+тор
modern=мо+дэрн
modesty=мо+дэсти
modification=модификэ+йшэн
modify=модифа+й
modulation=модюлэ+йшэн
mogadiscio=могади+шо
moikrug=мойкру+г
moines=муа+н
moisturise=мойсчура+йз
moisturize=мойсчура+йз
moldova=молдо+ва
moloko=молоко+
molotok=молото+к
momentary=мо+мэнтари
monday=ма+нди
mondeo=мандэ+о
mondial=мондиа+ль
mongolian=монго+лиан
monetary=мо+нэтари
money=ма+ни
moneygram=манигрэ+м
moneymail=манимэ+йл
monitor=мо+нитор
monkey=ма+нки
mono=мо+но
monolog=моноло+г
monsieur=месье+
monster=мо+нстэр
montaigne=монтэ+нь
montana=монта+на
montenegro=монтэнэ+гро
montevideo=монтэвидэ+о
montgomery=монтго+мэри
month=манс
montpelier=монпелье+
montreal=монреа+ль
more=мор
morgan=мо+рган
morissette=мо+рисэт
morning=мо+рнинг
morrow=мо+роу
mortal=мо+ртал
mortgage=мо+ргэдж
moscou=моску+
moscow=мо+скоу
moscowtimes=москоута+ймз
moses=мо+зэс
mosfilm=мосфи+льм
moskva=москва+
mosreklama=мосрекла+ма
most=мо+уст
mother=ма+зэр
mothercare=мазэркэ+р
motherhood=ма+зэрхуд
motherly=ма+зэрли
motion=мо+ушэн
moto=мо+то
motor=мо+тор
motorola=моторо+ла
motors=мо+торз
moulinex=мулинэ+кс
mountain=ма+унтин
mouret=мурэ+
mouse=ма+ус
mouth=ма+ус
move=мув
movie=му+ви
mozambique=мозамби+к
mozilla=мози+лла
mtonline=эмтэонла+йн
mucho=му+чо
mulberry=ма+лбэри
mult=мульт
multi=му+льти
multilane=мультилэ+йн
multilex=мультиле+кс
multimedia=мультиме+диа
multiplayer=мультиплэ+ер
multiple=ма+лтипл
multiplex=мультипле+кс
multiplication=малтипликэ+йшын
multiply=малтипла+й
multitran=мультитра+н
munchen=мю+нхен
mundial=мундиа+ль
mundo=му+ндо
munich=мю+ник
munster=мю+нстэр
murano=мура+но
murder=мё+рдэр
murdoch=мё+рдок
muscle=масл
musclenerd=маслнё+рд
muse=мью+з
musee=мюзэ+
museo=мусэ+о
museodelprado=мусэодэльпра+до
museum=мьюзи+ум
music=мью+зик
musica=му+зика
musician=мьюзи+шин
muslim=му+слим
mustang=муста+нг
mutandis=мута+ндис
mutatis=мута+тис
my=май
mybiz=майби+з
myford=майфо+рд
myspace=майспэ+йс
mystery=ми+стэри
nabucco=набу+кко
nacht=нахт
nagasaki=нагаса+ки
nails=нэ+илс
nairobi=найро+би
naked=нэ+йкэд
nakhichevan=нахичева+нь
name=нэйм
napoli=на+поли
narod=наро+д
narrow=нэ+роу
nascar=наска+р
nasdaq=насда+к
nashville=нэ+швил
nast=наст
natalia=ната+лиа
natalie=натали+
nathan=ната+н
nation=нэ+йшин
national=нэ+шинал
nationale=насьёна+ль
nationalgalerie=национальгалери+
nationalgallery=нэшиналгэ+лэри
nationalmuseum=национальмузэ+ум
native=нэ+йтив
natural=нэ+чэрал
nature=нэ+йче
naumen=на+умен
naval=нэ+йвал
navalny=нава+льны
navara=нава+ра
navigation=навигэ+йшен
navigator=навига+тор
navistar=нависта+р
navy=нэ+йви
nazi=на+ци
nazionale=национа+ле
ne=нэ
near=ни+эр
nebraska=нибра+ска
nebula=нэ+бьюла
nederland=нэ+дэрланд
need=нид
neglect=ниглэ+кт
negroponte=нэгропо+нтэ
neighbourhood=нэ+йбэрхуд
neither=на+йзэр
nelly=нэ+ли
neo=не+о
neowin=нэови+н
nerve=нёрв
nervous=нё+рвос
nescafe=нэскафэ+
nespresso=нэспрэ+ссо
net=нэт
netbook=нытбу+к
netbridge=нэтбри+дж
netbynet=нэтбайнэ+т
netflix=нэ+тфликс
netherlands=нэ+зерлэндс
netlog=нэтло+г
netmeeting=нэтми+тинг
netscape=нэтскэ+йп
network=нэ+творк
neu=ной
neue=но+йе
neva=нева+
nevada=нева+да
never=нэ+вэр
neverland=нэ+вэрлэнд
new=нью
newark=нью+арк
newlywed=ньюливэ+д
newmedia=ньюме+диа
newmont=нью+монт
news=ньюз
newsday=нью+здэй
newsinfo=ньюзи+нфо
newslab=ньюзлэ+б
newspaper=ньюзпэ+йпэр
newsru=ньюзру+
newstube=ньюзтью+б
newsweek=нью+свик
newtimes=ньюта+ймс
newyear=ньюйи+эр
nexidia=нэкси+диа
next=нэкст
nexus=нэ+ксус
nforce=энфо+рс
nginfo=энгэи+нфо
nice=найс
nicholas=ни+колас
nicholson=ни+колсон
nicolas=николя+
nicosia=никоси+я
niente=нье+нтэ
nigerian=найджи+риан
night=найт
nightingale=на+йтингэйл
nightmare=на+йтмэр
nike=найк
nikkei=никке+й
nikkey=никке+й
nikkor=нико+р
nikon=ни+кон
nine=на+йн
nineteen=найнти+н
ninety=на+йнти
nintendo=нинтэ+ндо
nirvana=нирва+на
nissan=нисса+н
nivea=ниве+я
nnov=энно+в
no=но+у
nobel=нобэ+л
noble=нобл
nobody=но+убади
noche=но+че
noel=ноэ+ль
noir=нуа+р
noise=нойз
noisy=но+йзи
nokia=но+киа
noname=ноунэ+йм
none=нан
nonreal=нонри+ал
norah=но+ра
nordavia=норда+виа
nordbank=но+рдбанк
nordwind=нордви+нд
normal=но+рмал
normalize=нормала+йз
nortel=но+ртэл
north=норс
northern=но+рзэрн
northwest=норсвэ+ст
norton=но+ртон
norwegian=норви+джен
nostalgia=носта+лджиа
not=нот
note=но+ут
notebook=ноутбу+к
notepad=ноутпэ+д
nothing=на+сынг
notification=нотификэ+йшен
notte=но+ттэ
nouakchott=нуакшо+т
nous=ну
nouveau=нуво+
nouvelle=нувэ+ль
novabus=новаба+с
novaya=но+вая
novayagazeta=новаягазе+та
novelist=но+вэлист
november=новэ+мбэр
novikov=но+виков
novoport=новопо+рт
novosibirsk=новосиби+рск
novoteka=новоте+ка
now=на+у
nowadays=науэдэ+йз
nowhere=но+увэр
nuance=ньюа+нс
nuclear=нью+клеар
nueva=нуэ+ва
nuevo=нуэ+во
nuisance=нью+сэнс
nuit=нюи+
nukus=нуку+с
num=нам
number=на+мбэр
nurburgring=нурбургри+нг
nursery=нё+рсэри
nutcracker=наткрэ+кер
nvidia=энви+диа
nvision=энви+жн
nymex=на+ймекс
oasis=оа+зис
obedience=оби+диенс
obedient=оби+диент
obituary=оби+тьюари
object=о+бджэкт
objective=обджэ+ктив
objet=обжэ+
oblast=о+бласть
oblasti=о+бласти
obscure=обскью+р
observatory=обзё+рватори
observe=обзё+рв
observer=обзё+рвэр
obvious=о+бвиэс
occasion=акэ+йжн
occupation=окьюпэ+йшен
occupy=окьюпа+й
ocean=о+ушэн
oceanic=оуше+аник
octavia=окта+виа
october=окто+бэр
odessa=одэ+сса
odyssey=о+диси
odnoklassniki=однокла+ссники
oeuvre=овр
of=ов
off=оф
offend=офэ+нд
offer=о+фэр
office=о+фис
official=офи+шэл
officiel=офисье+ль
offline=офла+йн
offshore=офшо+р
offspring=офспри+нг
often=офн
oh=о+у
ohio=ога+йо
oil=ойл
okado=ока+до
okay=оке+й
oklahoma=оклахо+ма
okna=о+кна
oleg=оле+г
olga=о+льга
oliver=о+ливер
olivier=оливье+
olympia=оли+мпия
olympic=оли+мпик
olympus=оли+мпус
omaha=о+маха
omega=оме+га
omit=оми+т
omnia=о+мниа
omnivision=омниви+жен
on=он
once=уа+нс
one=уа+н
online=онла+йн
onliner=онла+йнэр
only=о+нли
ontario=онта+рио
opel=о+пель
open=о+упэн
openoffice=опэно+фис
openspace=опэнспэ+йс
openstream=опэнстри+м
opera=о+пера
operate=аперэ+йт
operation=аперэ+йшэн
operative=о+ператив
operator=опера+тор
opinion=апи+ньэн
opponent=опо+нэнт
opportunity=опортью+нити
opposite=о+позит
opposition=опози+шын
optical=о+птикал
optima=о+птима
optimist=о+птимист
optimum=о+птимум
optimus=о+птимус
optique=опти+к
optronics=оптро+никс
oracle=о+ракл
orange=о+рандж
orbit=о+рбит
orbital=о+рбитал
orchestra=о+кестра
order=о+рдэр
oreal=ореа+ль
oregon=ориго+н
orenair=оренэ+йр
orenburg=оренбу+рг
organisation=организэ+йшен
organise=органа+йз
organization=организэ+йшен
organize=органа+йз
organizer=органа+йзер
orgspace=оргспэ+йс
oriental=ориэ+нтал
oriented=ориэ+нтэд
oriflame=орифлэ+йм
origin=о+риджин
original=ори+джинал
originality=ориджина+лити
orion=орио+н
orleans=орлиа+н
ornament=о+рнамэнт
orsay=орсэ+
orthographic=ортогра+фик
ortschaft=о+ртшафт
osbourne=о+сборн
osinka=оси+нка
other=а+зэр
otherwise=а+зэрвайз
otpbank=отэпэба+нк
ottawa=отта+ва
ouagadougou=уагаду+гу
ought=от
our=а+уэр
out=а+ут
outcast=аутка+ст
outdoor=аутдо+р
outlander=аутлэ+ндэр
outline=а+утлайн
outlook=аутлу+к
output=а+утпут
outside=аутса+йд
outward=а+утворд
over=о+увэр
overcome=овэрка+м
overflow=овэрфло+у
overture=о+вэрчур
overview=овэрвью+
overwright=овера+йт
owen=о+уэн
owl=а+ул
own=о+ун
owner=о+унэр
ownership=о+унэршип
oxygen=о+ксиджэн
oy=о+и
ozon=озо+н
ozzy=о+зи
paccar=пакка+р
pacific=паси+фик
pack=пэк
package=пэ+кидж
packard=па+кард
packet=пэ+кет
pad=пэд
padre=па+дрэ
page=пэйдж
pagerank=пэйджрэ+нк
paid=пэйд
paint=пэйнт
pais=паи+с
paix=пэ
pajero=паджэ+ро
pakistan=пакиста+н
palace=пэ+лэс
palais=палэ+
palazzo=пала+ццо
palette=пале+т
pall=пол
palm=палм
panasonic=панасо+ник
panda=па+нда
pandora=пандо+ра
panorama=панора+ма
pantech=пантэ+к
pantera=пантэ+ра
pantex=пантэ+кс
paolo=па+оло
pallmall=пэлмэ+л
palmolive=пальмоли+в
panthera=пантэ+ра
paparazzi=папара+цци
paper=пэ+йпэр
paradise=пэ+радайс
paramount=парама+унт
parfumeur=парфюмё+р
paribas=париба+
paris=пэ+рис
parisien=паризье+н
park=па+рк
parker=па+ркер
parlez=парлэ+
parliament=па+рламент
parrot=пэ+рот
parsifal=па+рсифаль
part=парт
participate=партисипэ+йт
particular=парти+кьюлар
partner=па+ртнэр
partnership=па+ртнэршип
party=па+ти
pascal=паска+ль
pasquale=паскуа+ле
pass=пас
passat=пасса+т
passenger=пэ+синджэр
password=па+сворд
paste=пэйст
pastry=пэ+йстри
patchouli=пачу+ли
patchwork=пэ+чворк
patek=патэ+к
patent=пэ+тэнт
paterson=па+тэрсон
path=пэс
pathfinder=пасфа+индэр
patience=пэ+йшэнс
patient=пэ+йшэнт
patriot=пэ+триот
patriotic=патрио+тик
patrizia=патри+ция
patrol=пэтро+л
pattaya=пата+йя
paul=пол
pause=поз
paw=по
pay=пэй
paypal=пэйпэ+л
pax=пакс
pc=писи+
peaceful=пи+сфул
pearl=пёрл
peas=пи+з
pechora=печо+ра
peculiar=пикью+лиар
pedigree=пэ+дигри
peking=пеки+н
pennsylvania=пенсильва+ния
pentagon=пентаго+н
pentium=пе+нтиум
people=пипл
pepe=пэ+пэ
peppers=пэ+перс
perez=пэ+рэс
perfect=пё+рфект
perfection=перфэ+кшын
perform=перфо+рм
performance=перфо+рманс
period=пи+риод
perm=пермь
permanent=пё+рманэнт
permission=пёрми+шын
perpetual=пэрпэ+чуал
perregaux=пэрэго+
perrier=пэрье+
persay=персэ+й
person=пё+рсон
persona=пэрсо+на
personal=пё+рсонал
personality=пэрсона+лити
persuade=персвэ+йд
persuasion=персвэ+йжын
pete=пит
peter=пи+тэр
peterbilt=пэтэрби+лт
peterburg=петербу+рг
petersburg=пи+тэрзбёрг
petersen=пэ+тэрсэн
petit=пти
petite=птит
petrobras=петробра+з
petrochina=петроча+йна
petroleum=петро+лиум
peugeot=пежо+
phaeton=фаэто+н
phantom=фэ+нтом
pharaoh=фэ+рао
philadelphia=филадэ+льфия
philharmoniker=филармо+никэр
philip=фи+лип
philippe=фили+п
philips=фи+липс
phillip=фи+лип
phillips=фи+липс
phoenix=фи+никс
phone=фо+ун
phonebook=фо+унбук
phoneme=фони+м
phonofont=фонофо+нт
photo=фо+то
photobank=фотоба+нк
photobucket=фотоба+кет
photoshop=фотошо+п
photoxpress=фотоэкспрэ+с
php=пиэйчпи+
physical=фи+зикал
physics=фи+зикс
physx=фи+зикс
piaget=пиаже+
piano=пья+но
piazza=пья+цца
picasso=пикассо+
picnic=пикни+к
picture=пи+кча
piece=пис
pierre=пье+р
pigeon=пи+джин
pinacotheque=пинакотэ+к
pinakothek=пинакотэ+к
pink=пи+нк
pinot=пино+
pinterest=пи+нтэрэст
pinto=пи+нто
pioneer=пайони+эр
pipe=пайп
pirate=па+йрэт
pirelli=пирэ+лли
pisem=пи+сем
pistols=пи+сталс
pixar=пикса+р
pixel=пи+ксел
pizza=пи+цца
place=плэйс
placebo=пласи+бо
placement=плэ+йсмэнт
plan=плэн
plane=плэйн
planet=плэ+нет
planeta=плане+та
plasa=пла+за
plaster=пла+стэр
plastic=пла+стик
platinum=пла+тинум
platoon=плату+н
play=плэй
playboy=плэйбо+й
player=плэ+ер
playlist=плэйли+ст
playstation=плэйстэ+йшэн
plaza=пла+за
pleasant=плэ+зант
please=плиз
pleasure=плэ+жэ
plural=плю+рал
plus=плюс
pm=пиэ+м
pnompenh=пномпе+нь
pochta=по+чта
pochtamt=почта+мт
pocketbook=покетбу+к
podcast=по+дкаст
podfm=подэфэ+м
podium=по+диум
poet=по+эт
poetry=по+этри
poezda=по+езда
pogoda=пого+да
point=по+йнт
poisk=по+иск
poison=по+йзон
poisonous=по+йзонэс
pokemon=покемо+н
pokrovka=покро+вка
polar=по+лар
polaris=пола+рис
polaroid=поларо+ид
polgaz=полга+з
police=пали+с
policy=по+лиси
polish=по+лиш
polit=поли+т
polite=пола+йт
politician=полити+шын
politics=по+литикс
politonline=политонла+йн
polo=по+ло
polski=по+льски
polyglot=полигло+т
pontiac=пантиа+к
popc=пиописи+
popov=попо+в
popular=по+пъюлар
population=попъюлэ+йшен
populus=по+пулюс
popup=попа+п
porcelain=по+рсэлэн
porsche=по+ршэ
port=порт
portal=порта+л
portishead=портисхэ+д
portland=по+ртланд
portofino=портофи+но
portrait=по+ртрит
portugal=по+рчугал
portugues=португэ+с
positive=по+зитив
positron=позитро+н
possession=пэзэ+шын
possessor=позэ+сор
possible=по+сибл
post=пост
postpone=постпо+ун
posthumous=по+стьюмос
potato=потэ+йто
poverty=по+вэрти
power=па+уэр
powercolor=пауэрка+лар
powerplay=пауэрплэ+й
powerpoint=пауэрпо+инт
powershift=пауэрши+фт
pr=пиар
practical=прэ+ктикал
practice=прэ+ктис
prada=пра+да
pravda=пра+вда
prawna=пра+вна
pray=прэй
precious=прэ+шэс
precision=прэси+жен
predator=прэ+датор
prediction=прэди+кшэн
prefer=префё+р
preference=прэ+фэрэнс
prejudice=прэ+джудис
preliminary=прэли+минари
premiair=премиэ+йр
premier=премье+р
premiere=премье+р
premio=прэ+мио
premium=пре+миум
prepare=припэ+р
present=прэ+зэнт
presentation=презентэ+йшэн
presented=призэ+нтэд
preservation=прэзэрвэ+йшен
president=прэ+зидэнт
presidential=прэзидэ+ншел
press=прэс
presse=прэ+ссэ
pressed=прэ+ст
pressure=прэ+шэ
prestigio=прэсти+джио
pretence=притэ+нс
pretend=притэ+нд
pretty=при+ти
prevention=превэ+ншэн
previa=прэ+виа
preview=при+вью
previous=при+виэс
prevost=прэво+ст
pribalt=приба+лт
primary=пра+ймари
primate=пра+ймат
prime=прайм
primera=приме+ра
primus=при+мус
pringles=принглс
princeton=при+нстон
principle=при+нсипл
print=принт
printemps=прынта+м
printer=при+нтэр
priora=прио+ра
prius=при+ус
privacy=пра+йвэси
private=пра+йвэт
prix=при
pro=про
probable=про+бэбл
problem=про+блем
procedure=проси+джер
proceedings=проси+дингз
process=про+сэс
processing=про+сэсинг
processor=про+сэсор
prodigy=про+диджи
prodli=продли+
produce=продъю+с
product=про+дакт
professional=профэ+шшэнал
professionnel=профэсьонэ+ль
profi=про+фи
profile=про+файл
program=про+грам
programme=про+грам
prohibit=прохи+бит
prohibited=прохи+битэд
prohibition=прохиби+шен
project=про+джэкт
prologue=проло+г
promaster=прома+стер
promise=про+мис
promo=про+мо
promotion=промо+ушен
pronunciation=пронансиэ+йшын
properties=про+пэртиз
property=про+пэрти
prosecutor=просэкью+тор
prosody=про+соди
protect=протэ+кт
protest=протэ+ст
protocol=про+токол
proton=прото+н
prototype=про+тотайп
prove=прув
provencal=прованса+ль
provence=прова+нс
provide=прова+йд
providence=про+видэнс
proxi=про+кси
proxima=про+ксима
psbank=пээсба+нк
psy=сай
psychology=сайко+лоджи
psychological=сайколо+джикал
psystar=сайста+р
pubblico=пу+блико
public=па+блик
publication=пабликэ+йшн
publicpost=пабликпо+ст
publish=па+блиш
published=па+блишт
publisher=па+блишэр
pulkovo=пу+лково
pullman=пу+лман
pulp=па+лп
pulsar=пульса+р
pulse=палс
puma=пу+ма
pumpkins=па+мпкинс
punctual=па+нкчал
punish=па+ниш
punishment=па+нишмэнт
punto=пу+нто
pupa=пу+па
purchase=пё+чэз
pure=пью+р
purevideo=пьюрви+део
purple=пёрпл
pursuit=пэрсью+т
push=пуш
pussy=пу+си
pussycat=пу+сикэт
put=пут
putin=пу+тин
putinu=пу+тину
pyongyang=пхенья+н
python=па+йтон
p.s.=постскриптум
qashqai=кашка+й
qatar=ката+р
qiwi=ки+ви
qos=кос
quadriga=квадри+га
quake=квэйк
qualcomm=квалко+м
qualification=кволификэ+йшын
qualify=кво+лифай
quality=кво+лити
quantas=ква+нтас
quantity=кво+нтити
quantum=ква+нтум
quarrel=кво+рэл
quart=кво+рт
quarter=кво+ртэр
quatro=ква+тро
quattro=ква+тро
quattron=кватро+н
queen=кви+н
question=квэ+счен
quick=квик
quiet=ква+йет
quintessential=квинтэсэ+ншел
quit=куи+т
quite=куа+йт
quiz=квиз
qosmio=ко+смио
qwerty=кве+рти
rabota=рабо+та
race=рэйс
racer=рэ+йсэр
rachid=раши+д
rachmaninov=рахма+нинов
racing=рэ+йсинг
ractis=ра+ктис
radeon=радэо+н
radical=рэ+дикал
radio=рэ+йдио
radiohead=радиохэ+д
radisson=рэ+дисон
rafael=рафаэ+ль
rafale=рафа+ль
raffaello=рафаэ+лло
rage=рэ+йдж
raiffeisen=райфа+йзен
raleigh=ро+ли
rambler=ра+мблер
rammstein=рамшта+йн
random=рэ+ндом
range=рэ+йндж
ranger=рэ+йнджэр
rapid=рэ+пид
rapidsoft=рэпидсо+фт
raptor=ра+птор
rar=рар
rasmus=ра+смус
rate=рэйт
rather=ра+зэр
rating=рэ+йтинг
ratio=рэ+йшио
rational=рэ+шэнал
ray=рэй
razor=рэ+йзор
reach=рич
read=рид
readme=ри+дми
ready=рэ+ди
real=ри+ал
realise=риала+йз
reality=риа+лити
realize=риала+йз
really=ри+али
realtek=риалтэ+к
realtime=риалта+йм
realty=ри+элти
reason=ри+зон
rebel=рэ+бэл
recall=рико+л
receipt=риси+т
receive=риси+в
recently=ри+сэнтли
reclaim=реклэ+йм
reclama=рекла+ма
recognition=рекогни+шэн
recommend=рекомэ+нд
recommended=рекомэ+ндэд
reconnaissance=рэконэ+йсанс
record=рэ+корд
recorder=рэко+рдэр
recording=рэко+рдинг
recover=рика+вэр
recovery=рика+вэри
recreate=рэкриэ+йт
recreation=рэкриэ+йшен
recycle=риса+йкл
red=рэд
redial=рэда+ил
redirect=рэдирэ+кт
redo=рэду+
reduce=ридью+с
reebok=ри+бок
referee=рэ+фэри
referendum=рэфэрэ+ндум
referent=рефере+нт
refresh=рифрэ+ш
refuse=рефъю+з
regard=рега+рд
regent=ри+джент
reggae=рэ+гги
region=ри+джэн
register=рэ+джистэр
registration=риджистрэ+йшн
regnum=рэ+гнум
regret=ригрэ+т
reject=редже+кт
rejoice=риджо+йс
rejuvenate=риджу+вэнэйт
relate=рилэ+йт
relation=рилэ+йшэн
relationship=рилэ+йшэншип
relatively=ре+лативли
relax=рилэ+кс
relay=рилэ+й
release=рили+з
released=рили+зд
reliable=рила+йабл
reliance=рела+йэнс
relief=рэли+ф
religion=рили+джэн
rely=рила+й
remain=римэ+йн
remedy=рэ+мэди
remembrance=римэ+мбранс
remind=рима+йнд
remote=ремо+ут
removal=рэму+вал
remove=рэму+в
renaissance=ринэ+йсанс
renard=рэна+р
renault=рено+
renesys=рэ+нэсис
renew=ренью+
renewable=ренью+абл
renoir=ренуа+р
repair=рипэ+ар
repeat=рипи+т
repetition=рэпэти+шын
replace=реплэ+йс
reply=рипла+й
report=репо+рт
reports=репо+ртс
repubblica=рэпу+блика
reproduce=рипродью+с
reproduction=рипрода+кшэн
republic=рипа+блик
reputation=рэпьютэ+йшын
request=риквэ+ст
requiem=рэ+квиэм
resсue=рэ+скъю
rescue=рэ+скью
research=рисё+рч
reserve=резё+рв
reserved=резё+рвд
reset=ресэ+т
resident=ре+зидент
resign=реза+йн
resist=рези+ст
resistance=рези+стэнс
resolution=резолю+шэн
resonator=резонэ+йтор
resort=ризо+рт
resource=ризо+рс
resources=ризо+рсис
responsibility=рэспонсиби+лити
restaurant=ре+стэрант
result=риза+лт
retail=ритэ+йл
retina=рэ+тина
retire=рита+йэр
return=ритё+рн
reuters=рэ+йтэрс
reveal=риви+л
revenge=ривэ+ндж
revenue=рэ+вэнью
reverse=ревё+рс
review=ревью+
revive=рива+йв
revival=рива+йвал
revolt=рево+лт
revolution=револю+шен
reward=риво+рд
rewind=рева+йнд
rhode=род
rian=ри+ан
ribbon=ри+бон
ricardo=рика+рдо
ricci=ри+чи
rice=райс
richmond=ри+чмонд
ricky=ри+ки
ridesafely=райдсэ+йфли
riding=ра+йдинг
rien=рьен
right=райт
riich=рии+ч
rijksmuseum=райксмузе+ум
rimini=ри+мини
rimr=римр
rinascente=ринашэ+нтэ
ring=ринг
rio=ри+о
riot=ра+йот
ripe=райп
ripen=ра+йпэн
rising=ра+йзинг
ritzio=ри+тцио
rival=ра+йвал
rivalry=ра+йвалви
rive=рив
riviera=ривье+ра
roadshow=роудшо+у
robbery=ро+бэри
robbie=ро+би
robert=ро+берт
robins=ро+бинс
robinson=ро+бинсон
roche=рош
rocher=роше+
rock=рок
rock'n'roll=рокнро+л
roderick=ро+дэрик
roewe=ро+эвэ
rolex=ро+лекс
rolf=рольф
roller=ро+ллер
rolling=ро+линг
roman=ро+ман
romance=ро+манс
romania=ромэ+ниа
romantika=рома+нтика
romanus=рома+нус
rome=ро+ум
romeo=рамэ+о
romir=роми+р
rory=ро+ри
rosbank=росба+нк
roseau=розо+
rosenthal=розента+ль
roses=ро+узес
roset=розэ+
rospil=роспи+л
rossia=росси+я
rossignol=росиньё+ль
rossiya=росси+я
rosukrenergo=росукрэнэ+рго
roth=рот
rothmans=ро+тманс
rothschild=ро+тшильд
rotten=ро+тэн
rouble=рубл
rouge=руж
rough=раф
rover=ро+вер
rovercomputers=роверкомпью+терс
roverpad=ровэрпэ+д
royal=ро+ял
royale=роя+ль
royalty=ро+ялти
rtf=эртээ+ф
rtvi=артивиа+й
ru=ру
rubber=ра+бэр
rubbish=ра+биш
rubinstein=рубинштэ+йн
ruble=рубл
rublevskoe=рублё+вское
rucenter=русэ+нтэр
rude=руд
rue=рю
ruhrgas=рурга+з
ruin=ру+ин
rule=рул
rumion=ру+мион
run=ран
runaway=ра+нэвэй
rundschau=ру+ндшау
runnet=раннэ+т
rus=рус
rusal=руса+л
russe=рюс
russia=ра+ша
russian=ра+шэн
russianpost=рашэнпо+ст
russiatoday=рашатудэ+й
russland=ру+сланд
rusventure=русвэ+нчер
ruthenia=рутэ+ниа
rutube=рутью+б
ryanair=райэнэ+йр
rykiel=рике+ль
rzeczpospolita=речьпосполи+та
saab=саа+б
saatchi=саа+тчи
sabbath=сэ+бэт
sachs=сакс
sacramento=сакрамэ+нто
sacred=сэ+йкред
sacrifice=сэ+крифайс
sadden=са+дэн
sade=шадэ+
safari=сафа+ри
safe=сэйф
safety=сэ+йфти
safran=сафра+н
said=сэд
sailor=сэ+йлор
saint=сэйнт
saints=сэ+интс
saison=сэзо+н
sakhalin=сахали+н
saks=сакс
salad=сэ+лад
sale=сэйл
salem=са+лем
salesforce=сэйлзфо+рс
salesman=сэ+йлзмэн
salomon=саломо+н
salt=солт
salvador=сальвадо+р
salvatore=сальвато+рэ
salzburg=за+льцбург
samara=сама+ра
sample=сэмпл
samsonite=самсона+йт
samsung=самсу+нг
samuel=сэ+мьюэл
samurai=самура+й
san=сан
sandy=сэ+нди
santa=са+нта
santana=санта+на
sanyo=са+нио
sapiens=са+пиэнс
sapienza=сапиэ+нца
sapphire=сапфи+р
sarah=са+ра
saransk=сара+нск
saratov=сара+тов
sas=сас
satellite=сэ+тэлайт
satisfaction=сэтисфэ+кшын
satisfy=сэтисфа+й
saturday=сэ+тэрдэй
sauvignon=совиньо+н
savanna=сава+нна
save=сэйв
saw=со
say=сэй
sbank=эсба+нк
sber=сбер
sberbank=сберба+нк
sbmag=эсбэма+г
scandinavian=скандинэ+виан
scandisk=сканди+ск
scania=ска+ниа
scanner=ска+нэр
scare=скэ+р
scene=син
scenery=си+нэри
scenic=сцэ+ник
schadenfreude=шадэнфро+йдэ
schering=ше+ринг
schiller=ши+ллер
schiphol=схи+пхол
schmidt=шмит
schmitt=шмит
schrift=шрифт
schubert=шу+берт
schumacher=шума+хер
schumann=шу+ман
schuster=шу+стэр
schwab=шваб
schwarzenegger=шварцнэ+гер
schwarzkopf=шварцко+пф
science=сайнс
sciencenow=сайнсна+у
sciences=са+йнсиз
scientific=сайэнти+фик
scientist=са+йэнтист
scion=са+йон
scissor=си+зар
scissors=си+зорс
scope=ско+уп
score=скор
scorpion=ско+рпион
scotia=ско+тиа
scottish=ско+тиш
scotland=ско+тланд
scotsman=ско+тсман
screen=скрин
screensaver=скринсэ+йвер
script=скрипт
scroll=скрол
seagate=сигэ+йт
search=сёрч
searchlight=сё+рчлайт
searchmonkey=сёрчма+нки
season=си+зон
seat=сиа+т
seattle=сиэ+тл
secam=сека+м
second=сэ+конд
secrecy=си+крэси
secret=си+крэт
secretary=сэ+крэтари
section=сэ+кшен
security=секью+рити
see=си
sega=се+га
segway=сигвэ+й
sehnsucht=зэ+йнзухт
selected=сэле+ктид
selection=сэле+кшын
semantic=сэма+нтик
senator=сэ+натор
senatus=сена+тус
send=сэнд
senior=си+ниор
sensai=сэнса+й
sensation=сэнсэ+йшен
sensational=сэнсэ+йшенал
senscare=сэнскэ+р
sensitive=сэ+нситив
sent=сэнт
seoul=сеу+л
separation=сэпарэ+йшын
september=сэптэ+мбэр
sera=сэ+ра
serbia=сё+рбиа
serbian=сё+рбиан
sergio=се+рджо
series=си+риэс
serious=си+риас
servant=сё+рвант
server=се+рвер
service=се+рвис
services=се+рвисэз
session=сэ+шэн
set=сэт
setting=сэ+тинг
seven=сэ+вэн
seventeen=сэвэнти+н
seventy=сэ+вэнти
several=сэ+вэрал
sex=сэ+кс
sexual=сэ+кшуал
seychelles=сейше+ль
shaanxi=шанкси+
shadow=шэ+доу
shakespeare=шекспи+р
shakhty=ша+хты
shakira=шаки+ра
shallow=шэ+лоу
shampoo=шампу+
shandong=шанду+н
shanghai=шанха+й
shangri=ша+нгри
share=шэр
shareware=шэарвэ+ар
sharp=шарп
shaving=ше+йвинг
she=ши
sheikh=шейх
shelby=шэ+лби
shell=шэл
sheraton=шерато+н
sheremetevo=шереме+тьево
sheremetyevo=шереме+тьево
shift=шифт
shilling=ши+линг
shock=шок
shockwave=шоквэ+йв
shop=шоп
shortage=шо+ртидж
shortcut=шо+рткат
shot=шот
should=шуд
show=шо+у
showcase=шоукэ+йс
showgirl=шоугё+л
showroom=шоуру+м
showtime=шоута+йм
shown=шо+ун
showthread=шоусрэ+д
shut=шат
siberian=сайби+риэн
sidekick=сайдки+к
sidney=си+днэй
siemens=си+мэнс
sigma=си+гма
sign=сайн
signal=си+гнал
signature=си+гнича
silence=са+йлэнс
silent=са+йлент
silicon=си+ликон
silja=си+лья
siljaline=сильяла+йн
silver=си+лвэр
silverlight=силвэрла+йт
silvio=си+львио
sim=сим
simbian=си+мбиан
simon=са+ймон
simple=си+мпл
simulator=симюлэ+йтор
sincerely=синси+рли
singapore=сингапу+р
singer=си+нгер
sinotruk=синотра+к
sipnet=сипнэ+т
sisley=сислэ+й
sistema=систе+ма
sister=си+стэр
site=сайт
sitepoint=сайтпо+йнт
sixteen=сиксти+н
sixty=си+ксти
size=сайз
skating=скэ+йтинг
skip=скип
skittles=скитлз
skoda=шко+да
sky=скай
skydrive=скайдра+йв
skyexpress=скайэкспрэ+с
skylab=скайлэ+б
skyline=скайла+йн
skylink=скайли+нк
skype=скайп
skyteam=скайти+м
skywest=скайвэ+ст
slavery=слэ+йвэри
sledgehammer=слэджхэ+ммэр
slim=слим
slippery=сли+пэри
slow=сло+у
small=смол
smallogger=смолло+гер
smart=смарт
smartscreen=смартскри+н
smartlogger=смартло+гер
smartmarketing=смартма+ркетинг
smartphone=смартфо+н
smashing=смэ+шинг
smith=смит
smolensk=смоле+нск
smotri=смотри+
snapdragon=снэпдрэ+гон
snickers=сни+керс
snow=сно+у
snowboard=сноубо+рд
sobchak=собча+к
sobinbank=собинба+нк
sobranie=собра+ние
soccer=со+кер
sochi=со+чи
social=со+ушэл
socially=со+шиали
socialist=со+шиалист
societe=сосьетэ+
societe=сосьетэ+
society=сыса+йети
socket=со+кет
soft=софт
software=софтвэ+ар
soir=суа+р
solaris=соля+рис
sold=со+лд
soldier=со+лджер
soleil=соле+й
solemn=со+лэм
solitaire=солитэ+р
solution=салю+шэн
some=сам
somebody=са+мбади
someone=са+муан
something=са+мсинг
sometime=самта+йм
sommeil=сомэ+й
son=сан
sonata=сана+та
sonia=со+ня
sony=со+ни
sophisticated=софистикэ+йтэд
sorcerer=со+рсэрэр
sorento=сорэ+нто
sorrow=со+роу
sorry=со+ри
sostav=соста+в
sotheby=со+тби
sotheby's=со+тбис
sotovik=сотови+к
soueast=сауи+ст
sought=сот
soul=со+ул
soulmate=со+улмэйт
sound=са+унд
soundcleaner=саундкли+нэр
soundkey=саундки+
soundmark=саундма+рк
soundtrack=саундтрэ+к
soup=суп
source=сорс
south=са+ус
southern=са+узэн
soviet=со+вьет
sovsport=совспо+рт
sow=со+у
soyat=соя+т
space=спэйс
spaceport=спэйспо+рт
sparrow=спэ+роу
spartacus=спа+ртакус
spatula=спэ+тьюла
spb=эспэбэ+
speak=спик
speaker=спи+кер
spears=спи+рс
special=спэ+шэл
specialist=спэ+шэлист
specom=спико+м
spectator=спектэ+йтор
spectra=спе+ктра
spectrometer=спектро+метр
speech=спич
speechcycle=спичса+йкл
speechpro=спичпро+
speechtek=спичтэ+к
speed=спид
sphere=сфир
spice=спа+йс
spider=спа+йдэр
spiegel=шпи+гель
spitalfields=спи+талфилдз
spoken=спо+укэн
sponsored=спо+нсорд
sport=спорт
sportage=спо+ртадж
sportbox=спортбо+кс
spravka=спра+вка
spread=спрэд
springer=спри+нгер
springfield=спри+нгфилд
sputnik=спу+тник
spyder=спа+йдэр
spyglass=спайгла+с
spyker=спа+йкер
spyware=спайвэ+ар
square=сквэ+р
ssangyong=сангйо+нг
stadium=стэ+диум
stalingrad=сталингра+д
stalker=ста+лкер
stampa=ста+мпа
standalone=стэндэло+н
standard=станда+рт
standart=станда+рт
standby=стэндба+й
standstill=стэ+ндстил
star=стар
starbucks=старба+кс
stardust=ста+рдаст
start=старт
starter=ста+ртэр
stasi=шта+зи
states=стэйтс
statesman=стэ+йтсмэн
station=стэ+йшэн
statoil=стато+йл
statoilhydro=статойлги+дро
status=ста+тус
steady=стэ+ди
steadyshot=стэдишо+т
steak=стэйк
stealth=стэлс
stedelijk=стэ+дэлик
stefani=стэфа+ни
stella=стэ+лла
stephanie=стэ+фани
stephen=сти+вэн
stereo=сте+рео
steve=сти+в
steven=сти+вэн
stiftung=шти+фтунг
stijl=стайл
stimorol=сти+морол
stinger=сти+нгер
stinol=стино+л
stockman=сто+кман
stockmann=сто+кман
stone=сто+ун
stones=сто+унз
stooges=сту+джэс
stop=стоп
storage=сто+ридж
store=стор
storyteller=сторитэ+лэр
strada=стра+да
strange=стрэндж
stranger=стрэ+нджэр
strategic=стратэ+джик
strategical=стратэ+джикал
strategy=стрэ+тэджи
straw=стро
street=стрит
stretcher=стрэ+тчер
strike=страйк
string=стринг
stripe=страйп
strogino=строгино+
stronger=стро+нгэр
strongest=стро+нгэст
structure=стра+кча
structural=стра+кчерал
studio=сту+дио
study=ста+ди
style=стайл
subaru=суба+ру
subject=са+бджэкт
sublime=сабла+йм
submarine=сабмари+н
subscribe=сабскра+йб
subscriber=сабскра+йбэр
subscription=сабскри+пшэн
subsidiary=сабси+диари
subversion=сабвё+ршен
subway=са+бвэй
succeed=сакси+д
success=саксэ+с
succession=саксэ+шен
sucre=су+кре
sudan=суда+н
sudanese=судани+з
sudden=са+дэн
suddeutsche=зюддо+йче
sueddeutsche=зюддо+йче
suede=свэйд
sugababes=щугабэ+йбс
sugar=шу+гар
suggest=садже+ст
suggestion=саджэ+сшын
suisse=суи+с
suit=сьют
suitcase=сью+ткэйс
suite=суи+т
suiza=сюи+за
sukhoi=сухо+й
sukhumi=суху+ми
sullivan=са+лливан
sultan=султа+н
sum=сам
summary=са+мари
summer=са+мэр
summertime=самэрта+йм
sun=сан
sunday=са+нди
sunexpress=санэкспрэ+с
sunny=са+ни
sunpack=санпэ+к
sunshine=са+ншайн
suomalainen=суо+малайнэн
suomi=суо+ми
super=су+пер
superb=сьюпё+рб
supergood=супергу+д
superjet=супердже+т
superjob=суперджо+б
supermarket=суперма+ркет
supersonic=суперсо+ник
superstar=суперста+р
supplement=са+плэмэнт
supplied=сапла+йд
supplies=сапла+йз
supply=сапла+й
support=саппо+рт
suppose=саппо+з
supra=су+пра
sure=шу+э
surface=сё+рфис
surfer=сё+рфер
surfing=сё+рфинг
surprise=сёрпра+йз
surround=сёрра+унд
survey=сё+рвэй
survive=сёрва+йв
susan=сью+зан
susanne=сюза+н
suspicion=сэспи+шын
suspicious=саспи+шес
sustain=састэ+йн
sustainable=састэ+йнабл
sustainability=састэйнаби+лити
suzuki=сузу+ки
svobodanews=свободанью+з
svyaznoy=связно+й
swallow=сво+лоу
swan=свон
swarovski=сваро+вски
swatch=своч
swear=свэ+ар
sweat=свэт
sweden=сви+дэн
sweetheart=сви+тхарт
swissotel=свисотэ+ль
switch=свич
switched=свичт
switzerland=сви+тзэрлэнд
swore=сво+р
sworn=сво+рн
sydney=си+днэй
symantec=симантэ+к
symbian=си+мбиан
symbol=си+мбол
symbolical=симбо+ликал
sympathy=си+мпати
symphony=си+мфони
sync=си+нк
synchronise=синкрона+йз
synchronization=синкронизэ+йшэн
synchronize=синкрона+йз
synchronized=синкрона+йзд
synchronizing=синкрона+йзинг
synchronous=синкро+нэс
synthesis=си+нтэсис
syria=си+рия
system=си+стэм
tab=таб
table=тэйбл
tabloid=табло+ид
tabu=табу+
tag=таг
taganrog=таганро+г
tagesspiegel=тагесшпи+гель
taiwan=тайва+нь
taj=тадж
tajik=таджи+к
take=тэйк
takeover=тэйко+вэр
talent=тэ+лэнт
talk=ток
talkboard=то+кборд
talking=то+кинг
tall=тол
tallahassee=талаха+си
tampere=та+мпэрэ
tangerine=тэнджери+н
tango=та+нго
tanya=та+ня
taobao=таоба+о
tape=тэйп
taperecorder=тэйпреко+рдэр
target=та+ргет
tariff=тэ+риф
tashkent=ташке+нт
task=таск
tasmania=тасма+ния
tatarstan=татарста+н
tate=тэйт
tatler=та+тлер
tattoo=тату+
tatuum=тату+ум
tau=та+у
taught=тот
tavern=тэ+вэрн
taxpayer=тэкспэ+йер
tbilisi=тбили+си
tchaikovsky=чайко+вский
team=тим
teana=тиа+на
tear=ти+ар
tech=тэк
techcrunch=тэккра+нч
technica=тэ+кника
technical=тэ+кникл
technologies=текно+лоджиз
technologizer=текнолоджа+йзэр
technology=текно+лоджи
techzone=техзо+н
teenage=ти+нэйдж
tefal=тефа+ль
teheran=тегера+н
telconet=телконэ+т
tele=те+ле
tele2=теледва+
telecom=телеко+м
telecommunication=телекомъюникэ+йшэн
telefon=телефо+н
telefonica=телефо+ника
telegraph=тэ+лиграф
telegraf=телегра+ф
telekom=телеко+м
telenor=телено+р
telephone=те+лефон
telescope=те+лескоп
telesystem=телеси+стэм
television=телеви+жн
telia=тэ+лиа
teliasonera=тэлиасонэ+ра
telkom=тэлко+м
tell=тэл
tellme=тэ+лми
temperature=тэ+мпричэ
temporary=тэ+мпорари
ten=тэн
teneues=тэно+йэс
tennessee=тэ+нэси
teodora=тэодо+ра
tequila=тэки+ла
tequilajazzzs=тэкиладжа+з
term=тёрм
terminal=тё+рминал
terminator=термина+тор
terrain=тэрэ+йн
terrazza=тэра+ца
territory=тэ+ритори
test=тэст
testing=тэ+стинг
tetra=тэ+тра
tetris=тэ+трис
texas=теха+с
texet=тексе+т
thalys=тали+с
than=зэн
thank=сэнк
that=зэт
thatcher=тэ+тчер
the=зэ
theater=ти+этэр
theatre=ти+этэр
theatrical=тиэ+трикал
their=зэ+ар
them=зэм
theme=сим
then=зэн
theory=ти+ори
there=зэ+ар
thermal=тэ+рмал
these=зиз
they=зэй
they've=зэйв
thing=сынг
thinkgeek=сынкги+к
thinkpad=сынкпэ+д
thirteen=сёрти+н
thirty=сё+рти
this=зис
thom=том
thomas=то+мас
thompson=то+мпсон
thomson=то+мсон
thos=тос
thorough=са+рэ
those=зо+уз
though=зо+у
thought=сот
thousand=са+узэнд
thread=трэд
threat=срэт
threaten=срэ+тэн
thriller=три+ллер
thrive=срайв
through=сру
thrown=сро+ун
thumb=сам
thunderball=сандэрбо+л
thunderbird=сандэрбё+рд
thunderbolt=сандэрбо+лт
thursday=сё+рзди
thus=зас
tibet=тибе+т
ticket=ти+кет
ticketline=тикетла+йн
tide=тайд
tidy=та+йди
tie=тай
tiffani=ти+фани
tiffany=ти+фани
tiger=та+йгэр
timberlake=ти+мбирлэйк
time=тайм
timeline=та+ймлайн
times=таймс
timewarner=таймуо+рнэр
tip=тип
title=тайтл
titograd=титогра+д
to=ту
toaster=то+стэр
tobacco=тобэ+кко
today=тудэ+й
tokio=то+кио
tokyo=то+кио
told=то+улд
tolstoi=толсто+й
tom=том
tomahawk=томага+вк
tomorrow=тумо+роу
tomtom=томто+м
tone=то+ун
tongue=танг
toni=то+ни
tonight=туна+йт
tony=то+ни
tool=тул
top=топ
topeka=то+пика
topic=то+пик
topnews=топнью+з
topshop=топшо+п
tori=то+ри
torino=тори+но
torneo=торнэ+о
toronto=торо+нто
torrent=то+рэнт
torrents=то+рэнтс
toshiba=то+шиба
total=то+тал
touareg=туарэ+г
touch=тач
touchpad=тачпа+д
touchscreen=тачскри+н
touchwiz=тачви+з
tough=таф
toujours=тужу+р
toulouse=тулу+з
tour=тур
tourism=тури+зм
tourizm=тури+зм
tourisme=тури+зм
tourismus=тури+змус
tournament=ту+рнамэнт
tout=ту
toward=туво+рд
tower=та+уэр
town=та+ун
toyota=тойо+та
track=трэк
tracker=трэ+кер
tracking=трэ+кинг
trade=трэйд
tradition=тради+шэн
traditional=тради+шэнал
traffic=трэ+ффик
train=трэйн
trainee=трэйни+
trans=транс
transaction=транзэ+кшэн
transaero=транса+эро
transavia=транса+виа
transcend=трансэ+нд
transcribe=транскра+йб
transcriber=транскра+йбер
transfer=тра+нсфер
transformer=трансфо+рмер
translate=транслэ+йт
translation=транслэ+йшэн
translator=транслэ+йтор
transmission=трансми+шэн
transparent=транспэ+рэнт
transparency=транспэ+рэнси
transport=тра+нспорт
travel=трэ+вел
traveller=трэ+вэлэр
travelocity=трэвэло+сити
tread=трэд
treasure=трэ+жэ
treasury=трэ+жэри
trendnet=трэнднэ+т
trenton=трэ+нтон
treyarch=трэйа+рч
trial=тра+йал
tribe=трайб
tribune=три+бьюн
tribute=три+бьют
trinity=три+нити
tripadvisor=трипадва+йзор
tristar=триста+р
triumf=триу+мф
triumph=триу+мф
tropez=тропэ+
tropical=тро+пикал
troubadour=трубаду+р
trouble=трабл
trud=труд
true=тру
trussardi=труса+рди
trust=траст
truth=трус
try=трай
tsar=царь
tube=тюб
tucano=тука+но
tucson=туксо+н
tuesday=тью+зди
tula=ту+ла
tumblr=та+мблер
tuning=тю+нинг
tunisair=тунисэ+йр
tunisia=туни+зиа
turbo=ту+рбо
turkey=тё+рки
turkish=тё+ркиш
turkmenistan=туркмениста+н
turner=тё+рнэр
turnstile=тёрнста+йл
tushino=ту+шино
tut=тут
tutu=туту+
tver=тверь
tverskaya=тверска+я
twelve=твэлв
twenty=твэ+нти
twilight=тва+йлайт
twingo=тви+нго
twitter=тви+ттыр
twix=твикс
two=ту
txt=тээкстэ+
tyler=та+йлир
type=тайп
typewriter=тайпра+йтэр
typhoon=тайфу+н
typical=ти+пикал
tzar=царь
ua=юэ+й
ubot=юбо+т
ubuntu=убу+нту
uffizi=уфи+ци
uk=юкэ+й
ukraine=юкрэ+йн
ukrainian=юкрэ+йниан
ukrenergo=укрэнэ+рго
ultima=у+льтима
ultimate=а+лтимат
ultra=у+льтра
ultrabook=ультрабу+к
ultravip=ультравиайпи+
umbrella=амбрэ+ла
umbro=а+мбро
uncut=анка+т
und=унд
under=а+ндэр
underage=андэрэ+йдж
undercover=андэрка+вэр
underground=андэргра+унд
underline=андэрла+йн
underlined=андэрла+йнд
underneath=андэрни+с
understand=андэрстэ+нд
understatement=андэрстэ+йтмент
understood=андэрсту+д
underworld=андэрво+рлд
underwriter=андэрра+йтэр
undo=анду+
undone=анда+н
unefon=унэфо+н
unembossed=анэмбо+ст
unfriend=анфрэ+нд
uniastrum=юниа+струм
unicom=юнико+м
unicredit=юникреди+т
unicreditbank=юникредитба+нк
unified=юнифа+йд
unilever=юниле+вер
union=ю+нион
uniqlo=юникло+
unique=юни+к
uninstall=анынсто+л
unisex=юнисэ+кс
unit=ю+нит
unite=юна+йт
united=юна+йтэд
unity=ю+нити
universal=юнивё+рсал
universe=ю+нивёрс
university=юнивё+рсити
unix=ю+никс
unlim=анли+м
unlimited=анли+митэд
unlock=анло+к
unpin=анпи+н
unplugged=анпла+гд
unreal=анри+ал
unreliable=анрила+йабл
unrest=анрэ+ст
unspecified=анспэ+сифайд
until=анти+л
untitled=анта+йтэлд
up=ап
update=апдэ+йт
updated=апдэ+йтэд
updation=апдэ+йшэн
upgrade=апгрэ+йт
upload=апло+уд
upon=апо+н
uppermost=а+пэрмост
upright=а+прайт
uprising=апра+йзинг
upset=апсэ+т
ural=ура+л
uralairlines=уралэ+йрлайнз
urals=ю+ралз
urgent=э+рджент
us=ас
usability=юзаби+лити
use=юз
used=юзд
user=ю+зэр
userfiles=юзэрфа+йл
uses=ю+зэз
using=юзинг
usual=южл
utah=ю+та
utility=юти+лити
utro=у+тро
utterance=а+тэранс
uusberb=уусбе+рб
uzbekistan=узбекиста+н
vacancy=вэ+йканси
vain=вэйн
vaio=ва+йа
valentine=вэлента+йн
valentino=валенти+но
valerio=вале+рио
valley=вэ+ли
valuable=вэ+льюэбл
value=вэ+лью
valuetech=вэльютэ+к
vanguard=вэ+нгард
vanitas=ва+нитас
vanity=ва+нити
vapor=вэ+йпор
variable=вэ+риабл
variation=вариэ+йшн
variety=вэра+йэти
vault=волт
vauxhall=во+ксол
vaz=ваз
vbank=вэба+нк
vectra=ве+ктра
vedomosti=ве+домости
vegas=ве+гас
vegetable=вэ+джэтабл
vehicle=викл
venere=вэнэ+рэ
venezuela=венесуэ+ла
venice=вэ+нис
venture=вэ+нче
venus=ви+нэс
verification=вэрификэ+йшэн
verify=вэрифа+й
verint=вэри+нт
verizon=веризо+н
vermont=вермо+нт
vernis=вэрни+
veronique=верони+к
versace=верса+че
verse=вёрс
version=вё+ршэн
vertigo=вё+ртиго
vertu=вэ+рту
vesti=ве+сти
viacom=виако+м
victoria=викто+риа
victory=ви+ктори
video=ви+део
vienna=виэ+на
vientiane=вьентья+н
vietnam=вьетна+м
view=вью
viewpad=вьюпэ+д
viewsonic=вьюсо+ник
viking=ва+йкинг
vikingline=вайкингла+йн
village=ви+лидж
ville=виль
villeneuve=вильнё+в
vilnius=ви+льнюс
vinci=ви+нчи
vintage=винта+ж
violence=ва+йолэнс
violent=ва+йолэнт
violet=ва+йолэт
virgin=вё+рджин
virginia=вирджи+ния
virtual=вё+рчуал
virus=ва+йрэс
visa=ви+за
visio=ви+зио
vision=ви+жэн
visit=ви+зит
vista=ви+ста
visual=ви+жуал
vital=ва+йтал
vitalvoice=вайталво+йс
vitara=вита+ра
vittore=витто+рэ
vittoriano=витториа+но
viva=ви+ва
vivaldi=вива+льди
vivier=вивье+
vizio=ви+зио
vkontakte=вконта+кте
vlingo=вли+нго
vocabulary=вокэ+бъюлари
vodafon=водафо+н
vodafone=водафо+н
vogue=вог
voice=войс
voicecom=войско+м
voicedigger=войсди+гер
voicegrid=войсгри+д
voicekey=войски+
voicenavigator=войснавига+тор
voicenet=войснэ+т
voicepin=войспи+н
voicevault=войсво+лт
voici=вуаси+
voila=вуаля+
vokrugsveta=вокругсве+та
volgograd=волгогра+д
volkswagen=фольксва+ген
voltage=во+льтидж
volume=во+лъюм
volvo=во+льво
von=фон
voronezh=воро+неж
vostock=восто+к
vostok=восто+к
vous=ву
vowel=ва+уэл
voxify=воксифа+й
voyager=во+яджер
vremya=вре+мя
vs=ве+рсус
vuitton=вюито+н
wacom=вако+м
waist=вэ+йст
wait=вэ+йт
waiting=вэ+йтинг
wakefield=вэ+йкфилд
wales=уэ+льс
walk=во+к
walkman=во+кман
wall=вол
wallpaper=волпэ+йпэр
walmart=во+лмарт
walt=волт
wander=во+ндэр
want=во+нт
wap=вап
war=вор
warcraft=во+ркрафт
ward=ворд
warehouse=вэ+рхаус
warfare=во+рфэр
warm=во+рм
warn=во+рн
warned=во+рнд
warner=во+рнэр
warning=во+рнинг
warsaw=уо+рсо
warship=во+ршип
warsteiner=варшта+йнер
was=воз
washington=ва+шингтон
waste=вэйст
watanabe=ватана+бэ
watch=воч
watchdog=во+чдог
water=во+тэр
watson=уо+тсон
wav=вав
wavesurfer=вэйвсё+рфер
way=вэ+й
we=ви+
we've=ви+в
wealth=вэ+лс
weapon=вэ+пон
wear=вэ+ар
wearable=вэ+арабл
weather=вэ+зэр
web=вэб
webbook=вэббу+к
webcreds=вэбкрэ+дс
webfeed=вэбфи+д
webmaster=вэбма+стер
webmoney=вэбма+ни
webtransfer=вэбтра+нсфэр
wednesday=уэ+нзди
week=ви+к
weekend=уикэ+нд
weigh=вэ+й
weihnachten=ва+йнахтэн
weihnachts=ва+йнахтс
welcome=вэ+лкам
welfare=вэ+лфэр
well=вэ+л
welle=вэ+лле
wellington=ве+лингтон
welt=вэ+льт
went=вэ+нт
were=вёр
west=вэст
westcall=вэстко+л
western=вэ+стэрн
westland=вэ+стланд
westlife=вэстла+йф
westmere=вэ+стмир
westminster=в+эстминстэр
wet=вэ+т
wetab=витэ+б
wharf=ворф
what=во+т
whatever=вотэ+вэр
wheel=ви+л
where=вэ+ар
wherever=вэрэ+вэр
whether=вэ+зэр
whichever=вичэ+вэр
while=ва+йл
whiskey=ви+ски
whitacre=ви+такр
white=ва+йт
whiten=ва+йтн
whitney=ви+тни
whoever=хуэ+вэр
whole=хо+ул
whore=хор
whose=хуз
why=вай
wichita=уичи+та
wicked=ви+кид
wide=ва+йд
widen=ва+йдэн
widescandisk=вайдсканди+ск
width=видс
wiedersehen=ви+дырзэйн
wifi=вайфа+й
wifire=вайфа+йр
wii=ви
wiki=ви+ки
wikileaks=викили+кс
wikimart=викима+рт
wikimedia=викиме+диа
wikipedia=википе+диа
wiktionary=ви+кшенари
wild=вайлд
wildе=уайлд
william=уи+льям
williams=ви+льямс
wilmington=ви+лмингтон
wimax=вайма+кс
win=вин
winamp=вина+мп
wind=винд
windhoek=ви+ндхук
window=ви+ндоу
windows=ви+ндоуз
windpad=виндпэ+д
windrose=виндро+уз
winmobile=винмоба+йл
winner=ви+нэр
winston=уи+нстон
wire=ва+йэр
wireless=ва+йрлэс
wisconsin=виско+нсин
wish=ви+ш
wishes=ви+шэз
with=ви+з
within=виси+н
without=виза+ут
witu=виту+
wizard=ви+зард
wolf=вулф
wolfram=вольфра+м
woman=ву+мын
women=ви+мын
won=уа+н
wonder=ва+ндэр
wonderful=ва+ндэрфул
wonderland=вандэрлэ+нд
wood=вуд
woollen=ву+лэн
woolworth=ву+лворт
word=ворд
wordpad=вордпэ+д
wordpress=вордпрэ+с
wore=вор
work=во+рк
workshop=во+ркшоп
worktime=воркта+йм
world=во+рлд
worldwide=ворлдва+йд
worry=ва+ри
would=вуд
wound=вунд
wow=ва+у
write=райт
wuerzburg=вю+рцбург
wyborcza=выбо+рча
wyoming=вайо+минг
xbox=иксбо+кс
xenia=ксе+ния
xerox=ксе+рокс
xiali=ксиали+
xpress=экспрэ+с
xpressmusic=экспрэсмью+зик
xtreme=экстри+м
yacht=йот
yahoo=яху+
yakovlev=я+ковлев
yamaha=яма+ха
yamal=яма+л
yamamoto=ямамо+то
yamoussoukro=ямусу+кро
yandex=я+ндэкс
yangown=янго+н
yaris=я+рис
yaroslavl=яросла+вль
yeah=е
year=йи+эр
yediot=едио+т
yedioth=едио+т
yellow=е+ллоу
yerevan=ерева+н
yes=ес
yesterday=е+стэрдэй
yet=ет
yoghurt=йо+гурт
yohji=йо+джи
york=йорк
yota=йо+та
you=ю
your=ёр
yourself=ёрсэ+лф
you've=юв
young=янг
your=ёр
youth=юс
youtube=ютью+б
yuejin=юджи+н
yugoslavia=югосла+виа
yves=ив
xperia=экспэ+риа
zachary=зэ+кари
zakupki=заку+пки
zanussi=зану+сси
zara=за+ра
zarplata=зарпла+та
zeit=цайт
zeitgeist=ца+йтгайст
zeitung=ца+йтунг
zenit=зени+т
zenith=зени+т
zeppelin=зэ+пилин
zero=зи+ро
zhongxing=жонгкси+нг
zimbabwe=зимба+бве
zinger=зи+нгер
zip=зип
zhurnal=журна+л
zone=зо+н
zoo=зу
zoom=зум
zoomby=зу+мби
zuercher=цю+рхэр
zurich=цу+рих
a-class=а+клас
ac-dc=эйсидиси+
add-on=эддо+н
al-jazeera=альджази+ра
alma-ata=алмаата+
anti-virus=антиви+рус
beaux-arts=боза+р
blu-ray=блюрэ+й
bubble-jet=баблджэ+т
c-class=цэ+клас
cd-r=сидиэ+р
cd-rom=сидиро+м
cd-rw=сидиэрвэ+
champs-elysees=шанзэлизэ+
coca-cola=кокако+ла
cr-v=сиарви+
dial-up=дайала+п
dvd-r=дивидиэ+р
dvd-rom=дивидиро+м
dvd-rw=дивидиэрвэ+
e-bay=ибэ+й
e-class=е+клас
e-mail=имэ+йл
france-presse=франспрэ+с
hands-free=хэндзфри+
high-tech=хайтэ+к
hi-fi=хайфа+й
hi-tech=хайтэ+к
hip-hop=хипхо+п
hr-v=эйчарви+
ink-jet=инкджэ+т
koi8-r=коивосемьэ+р
koi8-u=коивосемьу+
li-ion=литийио+н
lsd-monitor=элэздэмонито+р
mpeg-4=эмпегчеты+ре
ms-dos=эмэсдо+с
net-a-porter=нэтапортэ+
on-line=онла+йн
open-air=оупэн э+ир
pin-code=пинко+д
plug-in=плаги+н
pret-a-porter=прэтапортэ+
puk-code=пукко+д
r-n-b=арэнби+
rendez-vous=рандэву+
rock-n-roll=рокэнро+л
roller-skating=роллерске+йтинг
rolls-royce=ролсро+йс
s-class=э+с кла+с
sci-fi=сайфа+й
sim-card=симка+рд
tete-a-tete=тэтатэ+т
usb-port=юэсбипо+рт
usb-disc=юэсбиди+ск
usb-disk=юэсбиди+ск
utf-8=ютээфво+семь
water-proof=вотэпру+ф
water-resist=вотэрези+ст
web-master=вэбма+стер
wi-fi=вайфа+й
wal-mart=во+лмарт
x-mas=кри+смас
x-ray=эксрэ+й
x-trail=икстрэ+ил
mail.ru=мэ+йл ру+
boeing*=бо+инг*
d-*=дэ+ *
ip-*=айпи+ *
id-*=айди+ *
cd-*=сиди+ *
pc-*=писи+ *
dс-*=диси+ *
ti-*=ти+ай *
it-*=айти+ *
ai-*=эйа+й *
pr-*=пиа+р *
qr-*=кюэ+р *
qa-*=кюэ+й *
qt-*=кюти+ *
ip=айпи+
id=айди+
cd=сиди+
pc=писи+
dс=диси+
ti=ти+ай
it=айти+
ai=эйа+й
pr=пиа+р
qr=кюэ+р
qa=кюэ+й
qt=кюти+
crm=си+эрэм
bbc=бибиси+
forbes=фо+рбс
aliexpress=алиэкспрэ+с
bmw=бээмвэ+
mercedes-benz=мерседе+с-бенц
datsun=датсу+н
gmc=джиэмси+
hummer=ха+ммер
oldsmobile=o+лдсмобиль
tesla=те+сла
aurus=а+урус
ds=дээ+с
ravon=раво+н
zaz=заз
byd=бид
changan=чанга+н
cheryexeed=чериэксид
gac=гак
haval=хаве+йл
luxgen=лаксджин
zotye=зо+ти
wildberries=ва+йлдберриз
models=мо+дэлс
zoom=зу+м
bloomberg=блу+мберг
telegram=телегра+м
cnn=сиэнэ+н
nasa=на+са
swoosh=сву+ш
hashkey=хэшки+
firewalk=фа+йервок
revolut=револю+т
features=фичи+
smarttv=сма+рт тэвэ+
alexa=але+кса
deposit=депози+т
trader=тре+йдер
sidechat=сайтча+т
reels=ри+лс
kindle=ки+ндл
airbnb=айрбиэнби+
tokens=то+кенс
macos=ма+кос
spacy=спэ+йси
rollup=ролла+п
founders=фа+ундеры
challenges=че+лленджи
payments=пэ+йментс
highlights=хайла+йты
incubator=инкуба+тор
coinbase=ко+инбэйз
wechat=вича+т
rebase=рибэ+йз
coins=ко+инз
flex=фле+кс
tweets=твиты+
openai=опенэ+йай
revops=рево+пс
chatgpt=чатгэпэтэ+
tuned=тью+нд
hugging=ха+гинг
flows=фло+ус
hifi=хайфа+й
devops=дево+пс
startup=старта+п
startups=старта+пы
ops=о+пс
cofund=кофа+унд
uber=у+бер
proof=пру+ф
subgraphs=сабгра+фы
tiktok=тикто+к
tips=ти+пс
hub=ха+б
dumping=да+мпинг
hackathon=хакато+н
saas=са+с
labels=лэ+йблы
price=пра+йс
pytorch=пайто+рч
paramount=парамау+нт
snapchat=снапча+т
quest=кве+ст
crunch=кра+нч
spоtify=спотифа+й
app=а+пп
buddies=ба+ддис
spacex=спейси+кс
feelings=фи+лингс
shipping=ши+ппинг
startup=старта+п
blockchain=блокчэ+йн
camp=кэ+мп
foods=фy+дc
coinbase=коинбэ+йс
hathaway=хатавэ+й
seriously=си+риосли
unagi=уна+ги
zelda=зэ+лда
shaping=ше+йпинг
ryzen=ра+йзен
quadrata=куадра+та
founder=фа+ундер
flashloan=флашло+н
enix=и+никс
bitmain=битмэ+ин
savings=се+йвингс
greywing=гре+йвинг
generations=джэнэрейшэ+нс
voltswagen=фолтсва+ген
resilience=ризиля+нс
trading=тре+йдин
babylon=бабило+н
axle=а+ксл
price=пра+йс
voicemod=воисмо+д
soulbound=соулбоу+нд
knownorigin=кнаунори+гин
mayhem=мейхэ+м
raised=ре+йзд
pocket=паки+т
cardano=кардано+
hunters=ханте+рз
novastar=новаста+р
dena=ди+на
sameer=сами+р
deaton=дэато+н
merge=мо+рдж
shops=ша+пс
gauntlet=гонтлэ+т
robux=роба+кс
stanley=ста+нли
torgal=тоджа+л
magenta=мэджэ+нту
chain=че+йн
proved=прy+вд
immortals=иморту+лз
listeners=лисэне+рз
swytch=сви+тч
ios=айо+с
bears=бэ+рз
autopilot=аутопа+йлот
genrox=дженро+кс
bing=би+нг
workspace=воркспэ+йс
backup=бэка+п
airdrop=а+йрдроп
failures=фейлеэ+з
model=мо+дэл
bereal=берэа+л
overwatch=овэрва+тч
bedrock=бэдра+к
capella=капэ+лла
edgeof=иддже+оф
combinator=комбинэ+йтор
lemon=лэ+мэн
hedgehog=хэ+джхог
digits=диджэ+тс
januar=джейнюа+р
bundling=бандэ+лин
kyber=ки+бер
elevate=э+ливейт
arm=а+рм
haltian=халтиа+н
discord=диско+рд
depository=дипазэ+тори
americas=амэ+рикас
pledge=плэ+дж
transunion=трансунио+н
startups=ста+ртупс
chatbots=чатбо+тс
replit=рэ+плит
maersk=мээ+рск
mainnet=мэи+ннэт
fbi=эфбиа+й
anomalies=энамэ+лиз
loopin=лупи+н
avalor=авало+р
tonal=то+нал
consensus=кэнсэ+нсос
polydot=полидо+т
looking=лу+кин
softbank=софтбэ+нк
rollups=ролу+пс
chatting=ча+тинг
foscari=фоскари+
blockchain=блакчэ+йн
choke=чо+ук
turns=тё+рнз
energyx=инэ+рджиэкс
mchenry=мчэ+нри
derivatives=дэривэ+тивз
avata=ава+та
chromecast=кромэка+ст
webassembly=вэбассэ+мбли
botify=боти+фи
superchargers=сyпэтшарджэ+з
beats=би+тс
mining=майни+н
peckshield=пикшиэ+льд
epic=э+пик
emmy=э+ми
paxos=паксо+с
fluid=флyи+д
xiaomi=сяо+ми
soulja=соулдже+й
cofertility=кофэртили+ти
genshin=дже+ншин
hadid=хади+д
phalcon=фалко+н
luminar=лумина+р
bitwise=би+твис
mavis=ме+йви+с
gensler=дже+нслер
stability=стубилэ+ти
sec=сэ+к
cointelegrpah=коинтэлегрпа+х
crunchbase=кру+нчбас
appworks=аппво+ркс
kings=ки+нз
petty=пэ+ти
quartz=кво+ртс
verified=вэ+рэфа+йд
proof=прy+ф
kitakyushu=китаки+ушю
insider=инса+йдер
flamethrower=флеймтфрэ+уер
parent=пэрэ+нт
musicares=мусика+рэс
spring=спри+н
bitget=би+тджет
threading=тфрэ+дин
scan=ска+н
fingers=фингэ+з
officials=эфиши+лз
celeste=силэ+ст
shores=шо+рз
sandbox=сандбо+кс
smile=сма+йл
contracts=кантра+ктс
unpicking=анпи+кин
tempest=тэмпи+ст
zksync=зкси+нк
churn=чо+рн
lightroom=ли+гхтрум
strikers=стра+йкерз
chen=чэ+н
decisions=дэси+жэнз
redwood=рэ+двуд
luup=лю+уп
diablo=диа+бло
analyze=а+нэлаи+з
compatible=кэмпату+бл
ronbow=ронба+у
zevo=зэ+во
copilot=кэупаилэ+т
thrones=тфрэ+унз
schaback=сча+бек
ecoinometrics=икоиномэ+трикс
minecraft=майнэ+крафт
haystack=хе+йстак
offers=офе+рз
metaco=мэ+тако
district=ди+стрикт
receives=рэси+вз
blossom=бла+сим
execution=эксикью+шн
crypto=кри+пто
re=ри+
doing=дyи+н
mythic=ми+тфик
enel=инэ+ль
techcrunch=тэ+ккранч
swappi=сва+ппи
sandwiching=санвиджи+н
retention=ритэ+ншн
scuf=ска+ф
snap=сна+п
tyson=ти+сон
cars=ка+рз
inx=и+нкс
pactual=пактю+ал
asset=а+сэт
midjourney=мидджоу+рни
openzeppelin=опэнзэппи+лин
scaling=ске+йлин
github=гитха+б
robotics=роуба+тикс
designer=диза+йнер
arcimoto=а+ркимото
airlines=эрла+йнз
telecommunications=тэлекоммуникейшэ+нз
waymo=вэ+ймо
lens=лэ+нз
studios=сту+диоуз
tradingview=традингви+в
saber=се+йбер
giphy=ги+фи
trusted=трасти+д
gryphon=грифэ+н
ethereum=итэрэ+ум
deepmind=дипми+нд
arts=а+ртс
addressable=эдрэси+бл
starship=старши+п
practices=практисэ+з
helium=хи+лиэм
nakamigos=наками+гос
adoption=эда+пшн
edwards=идва+рдс
chatterbox=чатерба+кс
stabilityai=стабили+тиаи
brands=бра+ндз
casper=ка+спер
bitkraft=биткра+фт
wemix=вэ+микс
curious=кеу+риос
impact=и+мпакт
proposal=прэпоу+зл
bitrue=битрю+
bored=бо+рд
dollars=дале+рз
techtalks=тэчта+лкс
collaborative=кэлабере+йтив
flight=фла+йт
ganache=гана+ч
ecosystem=икоуси+стум
edmond=идмо+нд
preventative=прэвэнэ+див
bitboy=битбо+й
programmed=проугра+мд
fools=фy+лз
miax=ма+йакс
zenimax=зэни+мэкс
rovio=ро+вио
zebox=зэ+бокс
zenbook=зэ+нбук
insilico=инсилико+
lantian=лантиа+н
remake=риме+йк
octodad=октода+д
seagpt=сэа+гпт
analytica=энали+тика
regulation=рэгеале+йшн
cups=ка+пс
ripple=ри+пл
gaming=ге+йминг
mastery=ма+стери
fallout=фола+ут
huggingchat=хугги+нгчат
famiglia=фами+глиа
wax=ва+кс
kyberswap=ки+берсвап
moving=мyви+н
yardstick=еа+рдстик
exchanges=иксчейнджэ+з
marvels=марвэ+лз
nancy=на+нси
aveum=авэ+ум
infstones=инфсто+нэс
algorand=алгора+нд
mevblocker=мэвбло+кэр
heat=хи+т
starliner=старли+нэр
crusoe=крусо+
petal=пэ+тл
flatcoin=флаткои+н
homepods=хомэ+подс
musk=ма+ск
engage=инге+йдж
illivium=или+виум
crusader=крyсе+йдер
staking=сте+йкин
elements=элимэ+нтс
bitmoji=битмо+джи
carmacare=кармэ+ка
bittrex=биттрэ+кс
cybervault=киберво+лт
telehealth=тэлегеа+лт
greenworkx=гринво+рккс
gets=гэ+тс
eternal=и+торнл
pico=пи+ко
dragonfly=драгэнфла+й
aip=аи+п
legit=лиджи+т
coachella=кочэ+ла
decentrader=дэсэнтра+дэр
boomland=бумла+нд
grid=гри+д
cambrian=кэмбри+ан
bundler=ба+ндлер
cryptocurrencies=криптокаррэ+нкис
bitcoin=битко+ин
signalfire=сигна+лфи
bonqdao=бонкда+о
launch=ла+нч
hester=гестэ+р
jared=джейрэ+д
insurtechs=инсуртэ+кс
act=а+кт
eucoinotrade=эукоинотра+д
coin=ко+йн
bittorrent=битторрэ+нт
truthgpt=тру+тгпт
banken=банкэ+н
semgrep=сэмгрэ+п
masayoshi=мэсэйо+ши
keras=кэ+рас
creator=криэ+йтер
when=вэ+н
thodex=тодэ+кс
terran=тэ+рэн
bro=бро+
languages=лэнгви+джиз
fund=фа+нд
wavelength=ве+йвлэнтф
afford=эфо+рд
quickly=кви+кли
pos=по+с
implemented=имплимэнтэ+д
filbfilb=филбфи+лб
hutchison=ху+тчисон
wordle=во+рдл
sensetime=сэнсэ+тим
mobilecoin=мобилеко+ин
gods=га+дз
sell=сэ+л
rafti=ра+фти
pennies=пэ+низ
bluesky=блюэ+ски
rocket=ро+кет
secondary=сэкэндэ+ри
avoiding=иво+йдин
nat=на+т
extractable=икстракта+бл
truecaller=трюэка+ллер
subnets=субнэ+тс
autoleap=отолеа+п
gain=ге+йн
ledger=лэ+джер
supergiant=сyпэджа+йэнт
fomo=фо+мо
boring=бо+рин
oxenfree=оксэ+нфри
fraud=фро+д
personas=персона+лс
hunter=ха+нтер
metalpha=мэ+талфа
greycroft=гре+йкрофт
taskforce=та+скфорк
magsafe=мэ+гсаф
metamask=мэтамэ+ск
sushiswap=суши+свап
archivenode=арчивэ+нод
hijacking=хайджа+кин
thermostat=тформоста+т
credential=крэдэ+ншл
visibility=визэбелэ+ти
dirtygpt=дё+ртигпт
freecodecamp=фрикодэ+камп
repeatedly=рипити+дли
appruve=аппру+в
redfall=рэ+дфал
accelerators=аксэлере+йтэз
expansion=икспа+ншн
birds=бё+рдз
vesey=вэ+си
funding=фанди+н
liqudity=ликуди+ти
potential=пэтэ+ншл
greenbriar=гринбриа+р
ecosystem=икосу+стэм
docusign=докуса+инг
limewire=лимэ+ви
chair=чэ+р
cruise=крyи+с
landscape=лэ+ндскейп
dapps=да+ппс
herzigova=герзи+гова
asset=а+сэт
unibet=уни+бет
autogpt=ауто+гпт
mainnet=мэи+ннэт
shibarium=шиба+риум
headset=хэдсэ+т
polestar=полеста+р
accounts=экау+нтс
dogecoin=доджеко+ин
absolutely=абсила+тли
identify=айдэ+нтифай
tanso=тэ+нсо
tradelens=трэйдлэ+нс
hodlers=хо+длерс
disney=ди+снэй
interoperable=интероперэ+бл
cloud=кла+уд
pencil=пэ+нсл
alienfi=али+нфай
options=опшэ+нз
helps=хэ+лпс
angels=эйнджэ+лз
guarantee=гарэ+нти
mirrors=мире+рз
stadia=стейдя+
inspired=инспа+йерд
elon=ило+н
enforcement=инфорсмэ+нт
slam=сла+м
celcius=сэ+лкиус
moneytap=моне+йтап
bitcoin=битко+ин
partners=па+ртнерз
whales=ве+йлз
coinsquare=ко+инскюа
citypay=кити+пэй
ditto=диту+у
gohenry=гогенри+
greenfield=гринфиэ+льд
shortcuts=шо+рткат
innovamat=инновамэ+т
whisper=ви+спер
actual=а+кчэл
regulatory=рэгюлэ+тори
lookout=лукау+т
fleet=фли+т
clubhouse=кла+бхаус
steam=сти+м
otterize=оттэ+риз
illuvium=илу+виум
polkadotjs=полкадо+тджс
obligations=аблэге+йшэнз
vehemently=виамэ+нтли
supercharger=сyпэтша+рджер
conflux=канфла+кс
dolly=до+лли
bros=бро+с
lightning=ла+йтнин
noticed=ноути+ст
definitely=дэфинэ+тли
embraces=имбрейси+з
rhino=ра+йноу
quadream=кю+адрэам
squad=сква+д
reg=рэ+г
huge=хью+дж
aventurine=эвэнче+рин
oversubscribed=оверсабскра+йбэд
latest=лейти+ст
acorns=эйко+рнз
shall=ша+л
camp=ка+мп
solutions=солюшэ+нс
flatcoins=флаткои+нс
roomba=ру+мба
trine=тра+йн
fjord=фио+рд
brasil=бра+сил
aries=э+риз
cerbos=сэрбо+с
symbiosis=симбайэ+усис
helpful=хэ+лпфл
silk=си+лк
volatility=валэтилэ+ти
instacart=инштака+рт
lucid=лyси+д
skyrim=ска+йрим
qingdao=чинда+о
meet=ми+т
had=ха+д
blackstar=блэкста+р
toolkit=тyлки+т
seen=си+н
humanity=хьюманэ+ти
words=во+рдз
expectations=экспэкте+йшэнз
nest=нэ+ст
thai=та+й
certik=сэ+ртик
parler=парле+р
amc=эйэмси+
esports=испо+ртс
masimo=мэ+симо
growth=гро+утф
happens=хапэ+нз
tencent=тэнсэ+нт
camelot=камило+т
think=сы+нк
ispace=айспэ+йс
clara=кла+ра
opensea=опэ+нси
tinder=ти+ндер
changpeng=ча+нгпанг
cosco=коско+
sounds=са+ундз
fourthline=фо+уртлин
celsius=сэ+лсиос
grayscale=грэ+йскал
superchat=супи+рчат
when=вэ+н
allbridge=албри+дг
cryptocurrencies=криптокаррэ+нкис
anyscale=эни+скал
says=сэ+з
coro=ко+ро
interesting=интрэ+стин
mammoth=ма+мэтф
kaleo=кале+о
temple=тэ+мпл
swedish=сви+диш
ico=айсио+
horses=хорсэ+з
spacemen=спе+йсмэн
pinecone=пинэко+н
dydx=диуайдиэ+кс
investing=инвэ+стин
crush=кра+ш
dapp=да+пп
notes=но+утс
sbi=эсбиа+й
theranos=тэра+нос
filecoin=филекои+н
glassnode=гла+сснод
southwest=саутфвэ+ст
oleds=олэ+дс
exploring=икспло+рин
survivors=сервайве+рз
straubel=стробе+л
three=тфри+
lifeweaver=лифэвэ+авэр
labs=лэ+бз
shareplay=шарэплэ+й
gamestop=гамэсто+п
securities=сэкари+тис
adthos=а+дтос
assured=эшу+рд
davies=да+вис
upbit=апби+т
corractions=коррактио+нс
twisted=твисти+д
gelfire=дже+лфи
loco=ло+ко
evermile=ивэ+рмил
fires=файэ+з
luca=лу+ка
attacks=э+такс
bring=бри+н
shops=ша+пс
lockdown=лакдау+н
servitization=сэрвитизатио+н
enterprises=энтупрайзи+з
bitscrunch=би+тскрунч
worth=вё+з
socialfi=сокиа+лфи
friends=фрэ+ндз
westworld=вэ+створлд
chainalysis=чаина+лисис
mavic=ма+вик
ensure=иншу+р
transition=транзи+шн
bitfinex=битфи+нэкс
euler=э+йлер
surveillance=сорве+йлэнс
dapps=да+ппс
blocksec=бла+ксэк
howey=ха+уи
simcity=симаки+ти
looksrare=луксра+
chain=че+йн
dji=диджиа+й
angry=а+нгри
systems=систу+мз
shiba=ши+ба
ambassadeurs=амбассадэу+рс
elixir=и+ликсер
stablelm=стабле+лм
actually=акчэ+ли
quadball=кюадба+л
microstrategy=майкростратэ+джи
crackdown=кракда+ун
xenoblade=ксэнобла+д
significantly=сигнификэ+нтли
bertrand=бертра+нд
ipo=и+по
antbassador=энтбасса+дор
domains=доуме+йнз
subnets=субнэ+тс
accredify=аккрэ+дифи
ubereats=уберэа+тс
lazerpay=лазэрпэ+й
momiji=моми+джи
enskilda=ински+лда
fortnite=фортни+т
verge=во+рдж
freo=фрэ+о
enhanced=энха+нст
safemoon=сафэ+мун
quant=ква+нт
upwards=апве+рдз
chance=ча+нс
coreweave=корэвэ+ав
fakes=фе+йкс
chainstack=ча+инштек
yieldtrust=ииэльдтру+ст
augmented=огмэнти+д
apex=э+йпэкс
arcade=арке+йд
siri=си+ри
ciphertrace=кифэ+ртрак
persistent=персистэ+нт
ac=э+йси
closing=клоузи+н
friends=фрэ+ндз
road=ро+уд
capable=кейпэ+бл
reddit=рэ+ддит
avatars=авата+рз
altcoin=альтко+ин
middle=ми+дл
binance=байэ+нс
acolyte=акэла+йт
airpods=э+йрподс
shuttlers=шуттле+рс
deck=дэ+к
cryptbot=криптбо+т
jernigan=джэ+рниган
carsync=карси+нк
assets=а+сэтс
matrix=мэ+йтрикс
ventures=вэ+нчерз
stand=стэ+нд
etherscan=итэрска+н
lecun=леку+н
maximal=ма+ксимал
teams=ти+мз
debuts=дейбью+з
immutable=имьюту+бл
sepura=сэ+пура
maybe=ме+йби
prevent=привэ+нт
burner=борнэ+р
derivatives=дэривэ+тивз
optimism=оптими+зэм
rocketpool=рокэтпу+л
atm=эйтиэ+м
investors=инвэ+стерз
armored=арме+рд
such=са+ч
attachable=аттача+бл
chastain=часта+ин
flipboard=флипбо+рд
sims=си+мс
htoken=хтокэ+н
coast=ко+уст
wonderfi=вондэ+рфи
warren=ворэ+н
cartken=ка+рткэн
deepmind=дипми+нд
bitget=би+тджет
investments=инвэстмэ+нтс
book=бу+к
preventing=привэнти+н
tides=та+йдз
face=фе+йс
cashtags=ка+штагс
clarks=кла+ркс
signum=си+гнум
netbox=нэ+тбокс
fitbit=фитби+т
htokens=хто+кэнс
ways=ве+йз
decentralized=дэсэнтрэла+йзд
infogrid=инфогри+д
halo=хе+йлоу
nhtsa=нхтса+
relativity=рэлэ+тивэти
stryze=стри+з
brightdrop=бригхтдро+п
cerebral=сэрибрэ+л
babel=бе+йбл
workers=ворке+рз
mojave=модже+йв
altseason=алтсэасо+н
founder=фа+ундер
coaching=ко+утчин
robotic=робо+тик
discovery=диска+вери
citijerks=китиджэ+ркс
ryder=ри+дэр
speedometer=спидами+тер
oppo=оппо+
ceo=се+о
gaming=ге+ймин
stove=сто+ув
tether=тэ+зер
directstorage=даектстора+г
explains=икспле+йнз
staytuned=стэйтунэ+д
robinhood=робинху+д
antitrust=антитра+ст
indicators=индикэ+терз
thanks=тэ+нкс
vouchers=ва+учерз
huobi=хю+оби
walletconnect=валлетко+ннэкт
techstars=тэкста+рс
ostern=остэ+рн
bitlicense=битли+сэнс
chief=чи+ф
spruce=спрy+с
wired=ва+йерд
yonder=еа+ндер
equipme=икюи+пм
burning=бо+рнин
evo=и+во
opentowork=опинтауо+рк
seed=си+д
valisthea=валистэ+а
niu=ни+ю
grimes=гра+йм
roblox=ро+блокс
complement=камплимэ+нт
atms=эйтиэ+мз
gogoro=го+горо
druk=дру+к
reduced=рэ+дyст
liqpay=ликпэ+й
hearts=ха+ртс
blockchains=блакчэ+йнс
postfinance=постфи+нанк
chargel=ча+рджел
dapps=да+ппс
emblem=э+мблам
ports=по+ртс
roadster=ро+дстэр
making=ме+йкин
cybertruck=са+йбертрак
ether=ифе+р
has=хэ+з
mxnet=эмэкснэ+т
ripps=ри+ппс
brinkman=бринкмэ+н
instinct=инсти+нкт
credential=крэдэ+ншл
friendships=фрэ+ндчипс
fees=фи+з
depins=дэ+пинс
ehtereum=ихтэрэ+ум
mzero=мзэ+ро
zombies=замби+з
fields=фи+лдз
cosmonic=космо+ник
verto=вэ+рто
beacon=бикэ+н
cryptocurrency=криптокаррэ+нки
safetransact=сафэтранса+кт
polkadot=полкадо+т
openbazaar=опинбазаа+р
throne=тфро+ун
peckshield=пикшиэ+льд
kucoin=ку+коин
swiftkey=сви+фтки
options=опшэ+нз
zen=зэ+н
curation=каратио+н
mindverse=майндвэ+рс
midjourney=майдджоу+рни
bayc=бэ+йк
hindenburg=хиндэнба+дж
freethenipple=фритэни+ппл
mcu=эмсию+
weeknd=вике+нд
arrows=эрро+уз
cannot=кэно+т
illumina=илу+мина
did=ди+д
axie=акси+
peacock=пика+к
watches=ва+чэз
defi=дэ+фи
transistor=транзи+стер
awards=эво+рдз
including=и+нклyди+н
jack=джа+к
hey=хе+й
stories=сто+рис
brics=бри+кс
blockfi=бло+кфи
arkham=а+ркхам
bloomberggpt=блумбе+джгпт
congress=ка+нгрэс
developers=дивэла+перз
decentralization=дисэнтрэлэзе+йшн
eattheblocks=эаттэ+блокс
bullish=бу+лиш
collapse=кэла+пс
takeaways=тейкэ+вейз
cross=кро+с
hades=хейди+з
cispe=ки+сп
watchers=ва+черс
etoro=и+торо
unchained=а+нче+йн
api=эйпиа+й
kratos=крато+с
clarity=кларэ+ти
wells=вэ+лз
tensorflow=тэнсорфла+у
optimize=оптима+йз
cognitive=кагнэ+тив
truffle=тра+фл
sundar=сунда+р
covariant=кэувэря+нт
wrapped=ра+пт
bose=бо+с
cronus=кроно+с
stablecoins=стабле+коинс
svidaniya=свида+нииа
cracked=кра+кт
unstoppable=анста+пэбл
vulcan=вэ+лкэн
polychain=поличаи+н
tears=ти+рз
announcing=энаунси+н
connections=кэнэ+кшэнз
competitive=кэмпэтути+в
crypto=кри+пто
markets=маркэ+тс
vimeo=вимэ+о
sygnum=си+гнум
banks=бэ+нкс
levees=лэ+виз
lies=ла+йз
claims=кле+ймз
covert=ко+уворт
sol=со+ул
microsoft=майкросо+фт
