### Russian ###
Артур=Арту+р
Зеленина=Зеле+нина
Мирослава=Миросла+ва
Феликсовна=Фе+ликсовна
Назаровна=Наза+ровна
Фирдаус=Фирдау+с
Нурзия=Нурзия+
Вероника=Верони+ка
Арменовна=Арме+новна
Иванова=Ивано+ва
Вагина=Ва+гина
Говновна=Го+вновна
Федоровна=Фё+доровна
Фёдоровна=Фё+доровна
Юля=Ю+ля
Аля=А+ля
Федор=Фё+дор
Фёдор=Фё+дор
Женя=Же+ня
Петр=Пё+тр
Сергеевич=Серге+евич
Ангелина=Ангели+на
Бегалиевич=Бегали+евич
Сапаралиевич=Сапарали+евич
### Kazach ###
Абай=Аба+й
Абзал=Абза+л
Абыз=Абы+з
Абылай=Абыла+й
Агзам=Агза+м
Адиль=Ади+ль
Адия=Адия+
Ажар=Ажа+р
Азамат=Азама+т
Азат=Аза+т
Аида=Аида+
Айбала=Айбала+
Айбар=Айба+р
Айбарша=Айбарша+
Айбике=Айбике+
Айганша=Айганша+
Айгерим=Айгери+м
Айгул=Айгу+л
Айгуль=Айгу+ль
Айдана=Айдана+
Айдар=Айда+р
Айдос=Айдо+с
Айжамал=Айжама+л
Айжан=Айжа+н
Айзада=Айзада+
Айзия=Айзия+
Айман=Айма+н
Айнагул=Айнагу+л
Айнур=Айну+р
Айпара=Айпара+
Айсулу=Айсулу+
Айтолды=Айтолды+
Айтуган=Айтуга+н
Айша=Айша+
Аклима=Аклима+
Акмарал=Акмара+л
Акшора=Акшора+
Акылбай=Акылба+й
Акылжан=Акылжа+н
Алдияр=Алдия+р
Алия=Алия+
Алма=Алма+
Алтай=Алта+й
Алтын=Алты+н
Алтынбек=Алтынбе+к
Алтынгуль=Алтынгу+ль
Алуа=Алуа+
Альдаир=Альдаи+р
Альфия=Альфия+
Аман=Ама+н
Амина=Амина+
Амир=Ами+р
Анар=Ана+р
Анара=Анара+
Анаргуль=Анаргу+ль
Анвар=Анва+р
Ануар=Ануа+р
Аркат=Арка+т
Арман=Арма+н
Арнур=Арну+р
Ару=Ару+
Арынгазы=Арынгазы+
Арыстан=Арыста+н
Асан=Аса+н
Асель=Асе+ль
Асем=Асе+м
Асима=Асима+
Асия=Асия+
Аскар=Аска+р
Аскат=Аска+т
Атабай=Атаба+й
Атабек=Атабе+к
Атанияз=Атания+з
Атымтай=Атымта+й
Ахан=Аха+н
Ахат=Аха+т
Ахмет=Ахме+т
Ахрам=Ахра+м
Аян=Ая+н
Аяулым=Аяулы+м
Асхат=Асха+т
Багила=Багила+
Бадигулжамал=Бадигулжама+л
Базарайым=Базарайы+м
Байбарыс=Байбары+с
Байсал=Байса+л
Бакизат=Бакиза+т
Бакир=Баки+р
Бактияр=Бактия+р
Балжан=Балжа+н
Балшекер=Балшеке+р
Бану=Бану+
Барлас=Барла+с
Батес=Бате+с
Баттал=Батта+л
Бауыржан=Бауыржа+н
Бахыт=Бахы+т
Баязит=Баязи+т
Баян=Бая+н
Баят=Бая+т
Бекзат=Бекза+т
Берен=Бере+н
Берик=Бери+к
Бибигул=Бибигу+л
Бибигуль=Бибигу+ль
Бибинур=Бибину+р
Бимаржан=Бимаржа+н
Биржан=Биржа+н
Божей=Боже+й
Бокей=Боке+й
Бота=Бота+
Ботакоз=Ботако+з
Болат=Бола+т
Бошай=Боша+й
Буркан=Бурка+н
Габит=Габи+т
Газиза=Газиза+
Гайни=Гайни+
Гани=Гани+
Гарифолла=Гарифолла+
Гаухар=Гауха+р
Гафу=Гафу+
Гафура=Гафура+
Гулайым=Гулайы+м
Гулбаршын=Гулбаршы+н
Гулбахрам=Гулбахра+м
Гулжахан=Гулжаха+н
Гулзара=Гулзара+
Гулзифа=Гулзифа+
Гулмария=Гулмария+
Гулназ=Гулна+з
Гулниса=Гулниса+
Гулшара=Гулшара+
Гульшат=Гульша+т
Дамеля=Дамеля+
Дана=Дана+
Данара=Данара+
Дандай=Данда+й
Данеш=Дане+ш
Даниал=Даниа+л
Данияр=Дания+р
Дара=Дара+
Дарига=Дарига+
Дария=Дария+
Дармен=Дарме+н
Дастан=Даста+н
Демеу=Демеу+
Дилара=Дилара+
Дилда=Дилда+
Динара=Динара+
Дияр=Дия+р
Думан=Дума+н
Дурия=Дурия+
Дулат=Дула+т
Едиге=Едиге+
Елеу=Елеу+
Ерасыл=Ерасы+л
Ерболат=Ербола+т
Ерден=Ерде+н
Ердос=Ердо+с
Ержан=Ержа+н
Еркежан=Еркежа+н
Ермек=Ерме+к
Ерсайын=Ерсайы+н
Есей=Есе+й
Есен=Есе+н
Ескали=Ескали+
Елдос=Елдо+с
Жагыпар=Жагыпа+р
Жадигер=Жадиге+р
Жазира=Жазира+
Жайна=Жайна+
Жакия=Жакия+
Жалел=Жале+л
Жамал=Жама+л
Жамбыл=Жамбы+л
Жамига=Жамига+
Жамшид=Жамши+д
Жан=Жа+н
Жанабил=Жанаби+л
Жаназар=Жаназа+р
Жанар=Жана+р
Жанболат=Жанбола+т
Жангали=Жангали+
Жангир=Жанги+р
Жандос=Жандо+с
Жания=Жания+
Жансая=Жансая+
Жантуар=Жантуа+р
Жанша=Жанша+
Жарас=Жара+с
Жасулан=Жасула+н
Жарылкасын=Жарылкасы+н
Жетес=Жете+с
Жибек=Жибе+к
Жиренше=Жиренше+
Жолан=Жола+н
Жолгай=Жолга+й
Жолдас=Жолда+с
Жомарт=Жома+рт
Жулдыз=Жулды+з
Жумабике=Жумабике+
Жуман=Жума+н
Жунис=Жуни+с
Жупар=Жупа+р
Жусип=Жуси+п
Жанерке=Жанерке+
Зайыр=Зайы+р
Закария=Закария+
Заки=Заки+
Замзагул=Замзагу+л
Зара=Зара+
Зарина=Зарина+
Зауреш=Зауре+ш
Зейне=Зейне+
Зейнеп=Зейне+п
Зере=Зере+
Зиба=Зиба+
Зиягул=Зиягу+л
Зияда=Зияда+
Зиятбек=Зиятбе+к
Зубайда=Зубайда+
Зулкарнай=Зулкарна+й
Зулфия=Зулфия+
Зумрат=Зумра+т
Зылика=Зылика+
Илияс=Илия+с
Кадыр=Кады+р
Кажым=Кажы+м
Казтуган=Казтуга+н
Кайрат=Кайра+т
Кайсар=Кайса+р
Кайым=Кайы+м
Кайыргали=Кайыргали+
Каламкас=Каламка+с
Калима=Калима+
Калка=Калка+
Камалия=Кама+лия
Камария=Кама+рия
Камбар=Камба+р
Канат=Кана+т
Канипа=Канипа+
Карасай=Караса+й
Карим=Кари+м
Карлыгаш=Карлыга+ш
Кармыс=Кармы+с
Касиман=Касима+н
Касым=Касы+м
Касымхан=Касымха+н
Кахарман=Кахарма+н
Кемел=Кеме+л
Кобей=Кобе+й
Кобжан=Кобжа+н
Кобыланды=Кобыланды+
Коля=Ко+ля
Куаныш=Куаны+ш
Куланда=Куланда+
Кунке=Кунке+
Кунсулу=Кунсулу+
Лейла=Лейла+
Магауия=Магауия+
Магзум=Магзу+м
Мади=Мади+
Мадина=Мадина+
Мажит=Мажи+т
Максат=Макса+т
Малик=Мали+к
Малика=Малика+
Мамажан=Мамажа+н
Манап=Мана+п
Манар=Мана+р
Манас=Мана+с
Мансур=Мансу+р
Мархабат=Мархаба+т
Маулен=Мауле+н
Махамбет=Махамбе+т
Машрап=Машра+п
Медет=Меде+т
Медеу=Медеу+
Мейрам=Мейра+м
Меруерт=Меруе+рт
Мирас=Мира+с
Монке=Монке+
Мубарак=Мубара+к
Музаффар=Музаффа+р
Мукагали=Мукагали+
Мурат=Мура+т
Муса=Муса+
Мустафа=Мустафа+
Мухит=Мухи+т
Мухтар=Мухта+р
Макпал=Макпа+л
Наби=Наби+
Надир=Нади+р
Назарбай=Назарба+й
Накып=Накы+п
Нариман=Нарима+н
Ноян=Ноя+н
Нурлыбек=Нурлыбе+к
Нурсултан=Нурсулта+н
Ныгмет=Ныгме+т
Омар=Ома+р
Онгар=Онга+р
Ораз=Ора+з
Ораз-мухаммед=Ораз-мухамме+д
Орал=Ора+л
Ордабай=Ордаба+й
Олжас=Олжа+с
Рабига=Рабига+
Разия=Разия+
Райымбек=Райымбе+к
Райыс=Райы+с
Ракима=Ракима+
Ракия=Ракия+
Ракым=Ракы+м
Рауан=Рауа+н
Раушан=Рауша+н
Рахат=Раха+т
Рахила=Рахила+
Рахман=Рахма+н
Рашит=Раши+т
Рустем=Русте+м
Рустэм=Рустэ+м
Рухия=Рухия+
Руслан=Русла+н
Сабаз=Саба+з
Сабира=Сабира+
Сабит=Саби+т
Сагит=Саги+т
Саида=Саида+
Саймасай=Саймаса+й
Сайын=Сайы+н
Сакып=Сакы+п
Салтанат=Салтана+т
Сайран=Сайра+н
Самат=Сама+т
Санжар=Санжа+р
Сания=Сания+
Сара=Сара+
Саулет=Сауле+т
Саурык=Сауры+к
Сафуан=Сафуа+н
Сахи=Сахи+
Сейфолла=Сейфолла+
Серке=Серке+
Суйеу=Суйеу+
Сулеймен=Сулейме+н
Султан=Султа+н
Сулушаш=Сулуша+ш
Сырбай=Сырба+й
Сырым=Сыры+м
Тагай=Тага+й
Таймас=Тайма+с
Тайыр=Тайы+р
Такауи=Такауи+
Талип=Тали+п
Талмас=Талма+с
Таргын=Таргы+н
Тауман=Таума+н
Тауфик=Тауфи+к
Телжан=Телжа+н
Темирхан=Темирха+н
Тогжан=Тогжа+н
Торгын=Торгы+н
Уазипа=Уазипа+
Уайыс=Уайы+с
Уакап=Уака+п
Уали=Уали+
Уасила=Уасила+
Улан=Ула+н
Умбет=Умбе+т
Уркия=Уркия+
Фариза=Фариза+
Фатима=Фатима+
Фируза=Фируза+
Хамза=Хамза+
Хамит=Хами+т
Хафиз=Хафи+з
Шамсия=Шамсия+
Шынар=Шына+р
Шарбану=Шарбану+
Шарип=Шари+п
Шарипа=Шарипа+
Шашубай=Шашуба+й
Шерхан=Шерха+н
Шолпан=Шолпа+н
Шона=Шона+
Шора=Шора+
Ыбырай=Ыбыра+й
Ыдырас=Ыдыра+с
Ыксан=Ыкса+н
Ыскак=Ыска+к
Бауыржан=Бауыжа+н
Асхат=Асха+т
Дастан=Даста+н
Олжас=Алжа+с
Данияр=Дания+
Елдос=Елдо+с
Айман=Айма+н
Акмарал=Акмара+л
Айгерим=Айгери+м
Айжан=Айжа+н
Балжан=Балжа+н
Жансая=Жансая+
Аяулым=Аяулы+м
Алтын=Алты+н
Алма=Алма+
Касым=Касы+м
Кайрат=Кайа+т
Жанерке=Жанерке+
Еркежан=Еркежа+н
Жасулан=Жасула+н
Макпал=Макпа+
Бахыт=Бахы+т
Дулат=Дула+т
Канат=Кана+т
Болат=Бала+т
Асель=Асе+ль
Асем=Асе+м
Бота=Бата+
Шынар=Шына+
Сайран=Сайра+н
Жомарт=Жама+рт
Думан=Дума+н
Рустем=Русте+м
Руслан=Русла+н
Кайрат=Кайра+т
Жандарбек=Жандарбе+к
Дауренбек=Дауренбе+к
Сыйлыбек=Сы+ йлы+ бе+к
Савранбек=Савранбе+к
Нурымбет=Нурымбе+т
Рысбек=Рысбе+к
Адылет=Адыле+т
Улбике=Улъбике+
Илхам=Ильха+м
Еркин=Еркы+н
Есболсин=Есболсы+н
Турсынбек=Турсынбе+к
Газиза=Газиза+
Еркен=Ерке+н
Сеитжан=Сеитжа+н
Елнар=Ельна+р
Асел=Асе+ль
Ердаулет=Ердауле+т
Ерген=Ерге+н
Акниет=Акние+т
Сабыржан=Сабыржа+н
Сериковна=Се+риковна
Милана=Мила+на
Рустамкызы=Руста+м кызы+
