ч=час
мин=минута
сек=секунда
м=метр
см=сантиметр
мм=миллиметр
км=километр
г=грамм
кг=килограмм
т=тонна
шт=штука
га=гектар
руб=рубль
коп=копейка
чел=человек
р=рубль
тыс=тысяча
млн=миллион
млрд=миллиард
трлн=триллион
$=доллар
usd=доллар
eur=евро
б=байт
кб=килобайт
мб=мегабайт
тб=терабайт
пб=петабайт
тб=терабайт
стр=страница
вт=ват
квт=киловат
диагр=диаграмма
